시작에들어가	*시작에들어가/VV
갸우뚱갸우뚱	*갸우뚱갸우뚱/MAG
곤드레만드레	*곤드레만드레/MAG
구불텅구불텅	*구불텅구불텅/MAG
기연가미연가	*기연가미연가/MAG
기우뚱기우뚱	*기우뚱기우뚱/MAG
까르륵까르륵	*까르륵까르륵/MAG
꼬꼬댁꼬꼬댁	*꼬꼬댁꼬꼬댁/MAG
꼭두각시놀음	*꼭두각시놀음/NNG
꼼지락꼼지락	*꼼지락꼼지락/MAG
꾸르륵꾸르륵	*꾸르륵꾸르륵/MAG
꾸무럭꾸무럭	*꾸무럭꾸무럭/MAG
꿈지럭꿈지럭	*꿈지럭꿈지럭/MAG
다다귀다다귀	*다다귀다다귀/MAG
닥다글닥다글	*닥다글닥다글/MAG
달가닥달가닥	*달가닥달가닥/MAG
달그락달그락	*달그락달그락/MAG
덜거덩덜거덩	*덜거덩덜거덩/MAG
덜그럭덜그럭	*덜그럭덜그럭/MAG
덜커덕덜커덕	*덜커덕덜커덕/MAG
덩더꿍덩더꿍	*덩더꿍덩더꿍/MAG
두리번두리번	*두리번두리번/MAG
드르렁드르렁	*드르렁드르렁/MAG
드르륵드르륵	*드르륵드르륵/MAG
득시글득시글	*득시글득시글/MAG
따르릉따르릉	*따르릉따르릉/MAG
마스터베이션	*마스터베이션/NNG
뭉그적뭉그적	*뭉그적뭉그적/MAG
미루적미루적	*미루적미루적/MAG
밀치락달치락	*밀치락달치락/MAG
바드득바드득	*바드득바드득/MAG
바스락바스락	*바스락바스락/MAG
바지직바지직	*바지직바지직/MAG
부르릉부르릉	*부르릉부르릉/MAG
부스럭부스럭	*부스럭부스럭/MAG
붉으락푸르락	*붉으락푸르락/MAG
빠지직빠지직	*빠지직빠지직/MAG
뽀드득뽀드득	*뽀드득뽀드득/MAG
뿌드득뿌드득	*뿌드득뿌드득/MAG
스르륵스르륵	*스르륵스르륵/MAG
아기작아기작	*아기작아기작/MAG
아기족아기족	*아기족아기족/MAG
아사삭아사삭	*아사삭아사삭/MAG
어기적어기적	*어기적어기적/MAG
어기죽어기죽	*어기죽어기죽/MAG
어슬렁어슬렁	*어슬렁어슬렁/MAG
어쩌고저쩌고	*어쩌고저쩌고/MAG
어쩌구저쩌구	*어쩌구저쩌구/MAG
엎치락뒤치락	*엎치락뒤치락/MAG
오르락내리락	*오르락내리락/MAG
으르렁으르렁	*으르렁으르렁/MAG
이러쿵저러쿵	*이러쿵저러쿵/MAG
절거덕절거덕	*절거덕절거덕/MAG
절그럭절그럭	*절그럭절그럭/MAG
주르륵주르륵	*주르륵주르륵/MAG
주물럭주물럭	*주물럭주물럭/MAG
쪼르륵쪼르륵	*쪼르륵쪼르륵/MAG
찌그덕찌그덕	*찌그덕찌그덕/MAG
천부당만부당	*천부당만부당/NNG
철버덩철버덩	*철버덩철버덩/MAG
쿵더쿵쿵더쿵	*쿵더쿵쿵더쿵/MAG
퍼드덕퍼드덕	*퍼드덕퍼드덕/MAG
푸드덕푸드덕	*푸드덕푸드덕/MAG
푸드득푸드득	*푸드득푸드득/MAG
푸르릉푸르릉	*푸르릉푸르릉/MAG
허우적허우적	*허우적허우적/MAG
후두둑후두둑	*후두둑후두둑/MAG
후루룩후루룩	*후루룩후루룩/MAG
후비적후비적	*후비적후비적/MAG
흐느적흐느적	*흐느적흐느적/MAG
뒤치다꺼리	*뒤치다꺼리/NNG
디스카운트	*디스카운트/NNG
배리착지근	*배리착지근/NNG
아르바이트	*아르바이트/NNG
얼음지치기	*얼음지치기/NNG
업그레이드	*업그레이드/NNG
여천지무궁	*여천지무궁/NNG
와당탕퉁탕	*와당탕퉁탕/MAG
이어달리기	*이어달리기/NNG
자반뒤집기	*자반뒤집기/NNG
치국평천하	*치국평천하/NNG
허드렛소리	*허드렛소리/NNG
가가대소	*가가대소/NNG
가닥가닥	*가닥가닥/MAG
가득가득	*가득가득/MAG
가들가들	*가들가들/MAG
가랑가랑	*가랑가랑/MAG
가로쓰기	*가로쓰기/NNG
가루받이	*가루받이/NNG
가만가만	*가만가만/MAG
가물가물	*가물가물/MAG
가뭇가뭇	*가뭇가뭇/MAG
가분가분	*가분가분/MAG
가슬가슬	*가슬가슬/MAG
가슴앓이	*가슴앓이/NNG
가을걷이	*가을걷이/NNG
가을맞이	*가을맞이/NNG
가지치기	*가지치기/NNG
간난신고	*간난신고/NNG
간당간당	*간당간당/MAG
간댕간댕	*간댕간댕/MAG
간들간들	*간들간들/MAG
간명직절	*간명직절/NNG
간실간실	*간실간실/MAG
간질간질	*간질간질/MAG
갈팡질팡	*갈팡질팡/MAG
갉작갉작	*갉작갉작/MAG
감개무량	*감개무량/NNG
감옥살이	*감옥살이/NNG
감지덕지	*감지덕지/MAG
갑론을박	*갑론을박/NNG
강약부동	*강약부동/NNG
강종강종	*강종강종/MAG
개과천선	*개과천선/NNG
개굴개굴	*개굴개굴/MAG
객지살이	*객지살이/NNG
갸웃갸웃	*갸웃갸웃/MAG
거두절미	*거두절미/NNG
거들거들	*거들거들/MAG
거뜬거뜬	*거뜬거뜬/MAG
거뭇거뭇	*거뭇거뭇/MAG
거수경례	*거수경례/NNG
거슴츠레	*거슴츠레/MAG
거칠거칠	*거칠거칠/MAG
건들건들	*건들건들/MAG
걸쩍지근	*걸쩍지근/MAG
겅둥겅둥	*겅둥겅둥/MAG
겅정겅정	*겅정겅정/MAG
겅중겅중	*겅중겅중/MAG
게걸게걸	*게걸게걸/MAG
게슴츠레	*게슴츠레/MAG
견강부회	*견강부회/NNG
결가부좌	*결가부좌/NNG
결사반대	*결사반대/NNG
결자해지	*결자해지/NNG
결초보은	*결초보은/NNG
겸사겸사	*겸사겸사/MAG
경거망동	*경거망동/NNG
경세제민	*경세제민/NNG
경이원지	*경이원지/NNG
경천동지	*경천동지/NNG
고군분투	*고군분투/NNG
고기잡이	*고기잡이/NNG
고담준론	*고담준론/NNG
고도성장	*고도성장/NNG
고래잡이	*고래잡이/NNG
고립무원	*고립무원/NNG
고물고물	*고물고물/MAG
고분고분	*고분고분/MAG
고색창연	*고색창연/NNG
고생살이	*고생살이/NNG
고슬고슬	*고슬고슬/MAG
고실고실	*고실고실/MAG
고심참담	*고심참담/NNG
고용살이	*고용살이/NNG
고을살이	*고을살이/NNG
고정불변	*고정불변/NNG
고진감래	*고진감래/NNG
곤두박질	*곤두박질/NNG
골육상쟁	*골육상쟁/NNG
곰실곰실	*곰실곰실/MAG
곱슬곱슬	*곱슬곱슬/MAG
곱실곱실	*곱실곱실/MAG
공기놀이	*공기놀이/NNG
공도동망	*공도동망/NNG
공방살이	*공방살이/NNG
공사다망	*공사다망/NNG
공평무사	*공평무사/NNG
과대평가	*과대평가/NNG
과소평가	*과소평가/NNG
과잉보호	*과잉보호/NNG
관기숙정	*관기숙정/NNG
괄목상대	*괄목상대/NNG
광대무변	*광대무변/NNG
광명정대	*광명정대/NNG
구개음화	*구개음화/NNG
구구절절	*구구절절/NNG
구깃구깃	*구깃구깃/MAG
구덕구덕	*구덕구덕/NNG
구물구물	*구물구물/MAG
구불구불	*구불구불/MAG
구사일생	*구사일생/NNG
구슬치기	*구슬치기/NNG
구질구질	*구질구질/MAG
굴건제복	*굴건제복/NNG
굼실굼실	*굼실굼실/MAG
굽신굽신	*굽신굽신/MAG
궁싯궁싯	*궁싯궁싯/MAG
권토중래	*권토중래/NNG
귀양살이	*귀양살이/NNG
그득그득	*그득그득/MAG
그럭저럭	*그럭저럭/MAG
그렁그렁	*그렁그렁/MAG
그렁저렁	*그렁저렁/MAG
그루갈이	*그루갈이/NNG
그만저만	*그만저만/MAG
극악무도	*극악무도/NNG
근검절약	*근검절약/NNG
근질근질	*근질근질/MAG
근친상간	*근친상간/NNG
글썽글썽	*글썽글썽/MAG
긁적긁적	*긁적긁적/MAG
금시발복	*금시발복/NNG
금의환향	*금의환향/NNG
급전직하	*급전직하/NNG
기겁초풍	*기겁초풍/NNG
기고만장	*기고만장/NNG
기사회생	*기사회생/NNG
기상천외	*기상천외/NNG
기신기신	*기신기신/MAG
기웃기웃	*기웃기웃/MAG
기절초풍	*기절초풍/NNG
기진맥진	*기진맥진/NNG
기진역진	*기진역진/NNG
길쭉길쭉	*길쭉길쭉/MAG
까끌까끌	*까끌까끌/MAG
까닥까닥	*까닥까닥/MAG
까딱까딱	*까딱까딱/MAG
까막까막	*까막까막/MAG
까물까물	*까물까물/MAG
까뭇까뭇	*까뭇까뭇/MAG
까불까불	*까불까불/MAG
까슬까슬	*까슬까슬/MAG
까실까실	*까실까실/MAG
까악까악	*까악까악/MAG
까치걸음	*까치걸음/NNG
까칠까칠	*까칠까칠/MAG
깜박깜박	*깜박깜박/MAG
깜빡깜빡	*깜빡깜빡/MAG
깜짝깜짝	*깜짝깜짝/MAG
깡충깡충	*깡충깡충/MAG
깨갱깨갱	*깨갱깨갱/MAG
꺼끌꺼끌	*꺼끌꺼끌/MAG
꺼떡꺼떡	*꺼떡꺼떡/MAG
꺼뭇꺼뭇	*꺼뭇꺼뭇/MAG
꺼불꺼불	*꺼불꺼불/MAG
꺼칠꺼칠	*꺼칠꺼칠/MAG
껌벅껌벅	*껌벅껌벅/MAG
껌뻑껌뻑	*껌뻑껌뻑/MAG
껍신껍신	*껍신껍신/MAG
껍죽껍죽	*껍죽껍죽/MAG
껑청껑청	*껑청껑청/MAG
껑충껑충	*껑충껑충/MAG
께적께적	*께적께적/MAG
꼬깃꼬깃	*꼬깃꼬깃/MAG
꼬들꼬들	*꼬들꼬들/MAG
꼬리잡기	*꼬리잡기/NNG
꼬물꼬물	*꼬물꼬물/MAG
꼬박꼬박	*꼬박꼬박/MAG
꼬불꼬불	*꼬불꼬불/MAG
꼬장꼬장	*꼬장꼬장/MAG
꼬질꼬질	*꼬질꼬질/MAG
꼴깍꼴깍	*꼴깍꼴깍/MAG
꼼질꼼질	*꼼질꼼질/MAG
꼼짝달싹	*꼼짝달싹/MAG
꼼틀꼼틀	*꼼틀꼼틀/MAG
꾸깃꾸깃	*꾸깃꾸깃/MAG
꾸덕꾸덕	*꾸덕꾸덕/MAG
꾸들꾸들	*꾸들꾸들/MAG
꾸물꾸물	*꾸물꾸물/MAG
꾸벅꾸벅	*꾸벅꾸벅/MAG
꾸불꾸불	*꾸불꾸불/MAG
꾸뻑꾸뻑	*꾸뻑꾸뻑/MAG
꾸역꾸역	*꾸역꾸역/MAG
꿀꺽꿀꺽	*꿀꺽꿀꺽/MAG
꿀떡꿀떡	*꿀떡꿀떡/MAG
꿀럭꿀럭	*꿀럭꿀럭/MAG
꿀렁꿀렁	*꿀렁꿀렁/MAG
꿈적꿈적	*꿈적꿈적/MAG
꿈틀꿈틀	*꿈틀꿈틀/MAG
끄덕끄덕	*끄덕끄덕/MAG
끄떡끄떡	*끄떡끄떡/MAG
끄적끄적	*끄적끄적/MAG
끈적끈적	*끈적끈적/MAG
끈죽끈죽	*끈죽끈죽/MAG
끔벅끔벅	*끔벅끔벅/MAG
끔쩍끔쩍	*끔쩍끔쩍/MAG
끝마무리	*끝마무리/NNG
끼득끼득	*끼득끼득/MAG
끼룩끼룩	*끼룩끼룩/MAG
나긋나긋	*나긋나긋/MAG
나달나달	*나달나달/MAG
나실나실	*나실나실/MAG
나직나직	*나직나직/MAG
나풀나풀	*나풀나풀/MAG
낙심천만	*낙심천만/NNG
난형난제	*난형난제/NNG
날름날름	*날름날름/MAG
날씬날씬	*날씬날씬/MAG
날품팔이	*날품팔이/NNG
남부여대	*남부여대/NNG
남실남실	*남실남실/MAG
납작납작	*납작납작/MAG
낭창낭창	*낭창낭창/MAG
너글너글	*너글너글/MAG
너나들이	*너나들이/NNG
너덕너덕	*너덕너덕/NNG
너덜너덜	*너덜너덜/MAG
너울너울	*너울너울/MAG
너털너털	*너털너털/MAG
너풀너풀	*너풀너풀/MAG
널름널름	*널름널름/MAG
넓적넓적	*넓적넓적/MAG
넓죽넓죽	*넓죽넓죽/MAG
넘실넘실	*넘실넘실/MAG
넙적넙적	*넙적넙적/MAG
넙죽넙죽	*넙죽넙죽/MAG
노글노글	*노글노글/MAG
노릇노릇	*노릇노릇/MAG
노발대발	*노발대발/NNG
노심초사	*노심초사/NNG
녹신녹신	*녹신녹신/MAG
논공행상	*논공행상/NNG
농지거리	*농지거리/NNG
누덕누덕	*누덕누덕/MAG
누릇누릇	*누릇누릇/MAG
누에치기	*누에치기/NNG
뉘엿뉘엿	*뉘엿뉘엿/MAG
느글느글	*느글느글/MAG
느럭느럭	*느럭느럭/MAG
느릿느릿	*느릿느릿/MAG
느물느물	*느물느물/MAG
늘름늘름	*늘름늘름/MAG
늠실늠실	*늠실늠실/MAG
능글능글	*능글능글/MAG
능수능란	*능수능란/NNG
능지처참	*능지처참/NNG
능청능청	*능청능청/MAG
니글니글	*니글니글/MAG
다닥다닥	*다닥다닥/MAG
다독다독	*다독다독/MAG
다듬이질	*다듬이질/NNG
다리밟기	*다리밟기/NNG
다문다문	*다문다문/MAG
다복다복	*다복다복/MAG
다사다난	*다사다난/NNG
다솔식구	*다솔식구/NNG
다정다감	*다정다감/NNG
다종다양	*다종다양/NNG
단도직입	*단도직입/NNG
달강달강	*달강달강/MAG
달랑달랑	*달랑달랑/MAG
달싹달싹	*달싹달싹/MAG
달음박질	*달음박질/NNG
담쑥담쑥	*담쑥담쑥/MAG
당글당글	*당글당글/MAG
당일치기	*당일치기/NNG
대경실색	*대경실색/NNG
대굴대굴	*대굴대굴/MAG
대담무쌍	*대담무쌍/NNG
대동단결	*대동단결/NNG
대동소이	*대동소이/NNG
대롱대롱	*대롱대롱/MAG
대서특서	*대서특서/NNG
대서특필	*대서특필/NNG
대성통곡	*대성통곡/NNG
대자대비	*대자대비/NNG
댕강댕강	*댕강댕강/MAG
댕기풀이	*댕기풀이/NNG
더덕더덕	*더덕더덕/MAG
더듬더듬	*더듬더듬/MAG
더벅더벅	*더벅더벅/MAG
더부살이	*더부살이/NNG
더위팔기	*더위팔기/NNG
더펄더펄	*더펄더펄/MAG
덕지덕지	*덕지덕지/MAG
덜렁덜렁	*덜렁덜렁/MAG
덜레덜레	*덜레덜레/MAG
덜컥덜컥	*덜컥덜컥/MAG
덜컹덜컹	*덜컹덜컹/MAG
덥석덥석	*덥석덥석/MAG
덩실덩실	*덩실덩실/MAG
데굴데굴	*데굴데굴/MAG
데룽데룽	*데룽데룽/MAG
데면데면	*데면데면/MAG
뎅강뎅강	*뎅강뎅강/MAG
뎅겅뎅겅	*뎅겅뎅겅/MAG
도란도란	*도란도란/MAG
도리머리	*도리머리/NNG
도원결의	*도원결의/NNG
도중하차	*도중하차/NNG
독립운동	*독립운동/NNG
독수공방	*독수공방/NNG
독야청청	*독야청청/NNG
돋을새김	*돋을새김/NNG
동고동락	*동고동락/NNG
동글동글	*동글동글/MAG
동문서답	*동문서답/NNG
동문수학	*동문수학/NNG
동병상련	*동병상련/NNG
동분서주	*동분서주/NNG
동시통역	*동시통역/NNG
동실동실	*동실동실/MAG
동심협력	*동심협력/NNG
동족상잔	*동족상잔/NNG
두근두근	*두근두근/MAG
두둘두둘	*두둘두둘/MAG
두런두런	*두런두런/MAG
두루뭉실	*두루뭉실/NNG
두리두리	*두리두리/MAG
두릿두릿	*두릿두릿/MAG
두문불출	*두문불출/NNG
두벌매기	*두벌매기/NNG
두주불사	*두주불사/NNG
둘레둘레	*둘레둘레/MAG
둥글둥글	*둥글둥글/MAG
둥당둥당	*둥당둥당/MAG
둥실둥실	*둥실둥실/MAG
뒤뚱뒤뚱	*뒤뚱뒤뚱/MAG
뒤룩뒤룩	*뒤룩뒤룩/MAG
뒤적뒤적	*뒤적뒤적/MAG
뒤죽박죽	*뒤죽박죽/NNG
뒷마무리	*뒷마무리/NNG
뒷바라지	*뒷바라지/NNG
뒷설거지	*뒷설거지/NNG
드난살이	*드난살이/NNG
드라이브	*드라이브/NNG
드래프트	*드래프트/NNG
드럭드럭	*드럭드럭/MAG
드릉드릉	*드릉드릉/MAG
드문드문	*드문드문/MAG
득실득실	*득실득실/MAG
득의만면	*득의만면/NNG
득의양양	*득의양양/NNG
들락날락	*들락날락/MAG
들먹들먹	*들먹들먹/MAG
들썩들썩	*들썩들썩/MAG
들쑥날쑥	*들쑥날쑥/MAG
들쭉날쭉	*들쭉날쭉/MAG
들척들척	*들척들척/MAG
듬뿍듬뿍	*듬뿍듬뿍/MAG
듬성듬성	*듬성듬성/MAG
디굴디굴	*디굴디굴/MAG
디룩디룩	*디룩디룩/MAG
따끈따끈	*따끈따끈/MAG
따끔따끔	*따끔따끔/MAG
따닥따닥	*따닥따닥/MAG
따독따독	*따독따독/MAG
딱지치기	*딱지치기/NNG
딸랑딸랑	*딸랑딸랑/MAG
때각때각	*때각때각/MAG
때굴때굴	*때굴때굴/MAG
때록때록	*때록때록/MAG
땡글땡글	*땡글땡글/MAG
떠듬떠듬	*떠듬떠듬/MAG
떨렁떨렁	*떨렁떨렁/MAG
떼굴떼굴	*떼굴떼굴/MAG
또각또각	*또각또각/MAG
또글또글	*또글또글/MAG
또랑또랑	*또랑또랑/MAG
또렷또렷	*또렷또렷/MAG
또록또록	*또록또록/MAG
또릿또릿	*또릿또릿/MAG
또박또박	*또박또박/MAG
똑딱똑딱	*똑딱똑딱/MAG
뚜걱뚜걱	*뚜걱뚜걱/MAG
뚜렷뚜렷	*뚜렷뚜렷/MAG
뚜룩뚜룩	*뚜룩뚜룩/MAG
뚜릿뚜릿	*뚜릿뚜릿/MAG
뚜벅뚜벅	*뚜벅뚜벅/MAG
뚝딱뚝딱	*뚝딱뚝딱/MAG
뜨끈뜨끈	*뜨끈뜨끈/MAG
뜨끔뜨끔	*뜨끔뜨끔/MAG
뜨문뜨문	*뜨문뜨문/MAG
띄어쓰기	*띄어쓰기/NNG
띄엄띄엄	*띄엄띄엄/MAG
리메이크	*리메이크/NNG
리바이벌	*리바이벌/NNG
마른기침	*마른기침/NNG
마른빨래	*마른빨래/NNG
마수걸이	*마수걸이/NNG
막무가내	*막무가내/NNG
만고불변	*만고불변/NNG
만병통치	*만병통치/NNG
만부득이	*만부득이/MAG
만사태평	*만사태평/NNG
만사형통	*만사형통/NNG
만수무강	*만수무강/NNG
만수받이	*만수받이/NNG
만질만질	*만질만질/MAG
말똥말똥	*말똥말똥/MAG
말랑말랑	*말랑말랑/MAG
망연자실	*망연자실/NNG
매관매직	*매관매직/NNG
매끈매끈	*매끈매끈/MAG
매끌매끌	*매끌매끌/MAG
매수공작	*매수공작/NNG
맨송맨송	*맨송맨송/MAG
맨숭맨숭	*맨숭맨숭/MAG
맹숭맹숭	*맹숭맹숭/MAG
머뭇머뭇	*머뭇머뭇/MAG
머슴살이	*머슴살이/NNG
멀뚱멀뚱	*멀뚱멀뚱/MAG
멈칫멈칫	*멈칫멈칫/MAG
멍석말이	*멍석말이/NNG
메슥메슥	*메슥메슥/MAG
메이크업	*메이크업/NNG
멱살잡이	*멱살잡이/NNG
면종복배	*면종복배/NNG
명견만리	*명견만리/NNG
명실상부	*명실상부/NNG
명약관화	*명약관화/NNG
명예퇴직	*명예퇴직/NNG
모개흥정	*모개흥정/NNG
모기르기	*모기르기/NNP
모니터링	*모니터링/NNG
모래찜질	*모래찜질/NNG
모략중상	*모략중상/NNG
목욕재계	*목욕재계/NNG
몽글몽글	*몽글몽글/MAG
몽긋몽긋	*몽긋몽긋/MAG
몽실몽실	*몽실몽실/MAG
무궁무진	*무궁무진/NNG
무단가출	*무단가출/NNG
무단결근	*무단결근/NNG
무단결석	*무단결석/NNG
무단이탈	*무단이탈/NNG
무릎꿇림	*무릎꿇림/NNG
무릎맞춤	*무릎맞춤/NNG
무문농필	*무문농필/NNG
무미건조	*무미건조/NNG
무변광대	*무변광대/NNG
무병장수	*무병장수/NNG
무불통지	*무불통지/NNG
무사자통	*무사자통/NNG
무사타첩	*무사타첩/NNG
무사태평	*무사태평/NNG
무사통과	*무사통과/NNG
무상출입	*무상출입/NNG
무색무취	*무색무취/NNG
무소부지	*무소부지/NNG
무소불능	*무소불능/NNG
무소불위	*무소불위/NNG
무시무종	*무시무종/NNG
무실역행	*무실역행/NNG
무위도식	*무위도식/NNG
무위무책	*무위무책/NNG
무위이화	*무위이화/NNG
무임승차	*무임승차/NNG
무전취식	*무전취식/NNG
무지몽매	*무지몽매/NNG
무지무지	*무지무지/MAG
묵묵부답	*묵묵부답/NNG
묵은세배	*묵은세배/NNG
문명개화	*문명개화/NNG
문무겸전	*문무겸전/NNG
문적문적	*문적문적/MAG
문전걸식	*문전걸식/NNG
물긋물긋	*물긋물긋/MAG
물렁물렁	*물렁물렁/MAG
물실호기	*물실호기/NNG
물심부름	*물심부름/NNG
물씬물씬	*물씬물씬/MAG
물약자효	*물약자효/NNG
물컹물컹	*물컹물컹/MAG
물큰물큰	*물큰물큰/MAG
뭉글뭉글	*뭉글뭉글/MAG
뭉실뭉실	*뭉실뭉실/MAG
뭉클뭉클	*뭉클뭉클/MAG
뭉텅뭉텅	*뭉텅뭉텅/MAG
미구불원	*미구불원/NNG
미끈미끈	*미끈미끈/MAG
미끌미끌	*미끌미끌/MAG
미음완보	*미음완보/NNG
미적미적	*미적미적/MAG
민숭민숭	*민숭민숭/MAG
민족상잔	*민족상잔/NNG
바글바글	*바글바글/MAG
바깥출입	*바깥출입/NNG
바꿔치기	*바꿔치기/NNG
바둥바둥	*바둥바둥/MAG
바득바득	*바득바득/MAG
바들바들	*바들바들/MAG
바락바락	*바락바락/MAG
바람막이	*바람막이/NNG
바삭바삭	*바삭바삭/MAG
바싹바싹	*바싹바싹/MAG
바작바작	*바작바작/MAG
박리다매	*박리다매/NNG
박장대소	*박장대소/NNG
박학다문	*박학다문/NNG
박학다식	*박학다식/NNG
반가부좌	*반가부좌/NNG
반드르르	*반드르르/MAG
반들반들	*반들반들/MAG
반듯반듯	*반듯반듯/MAG
반생반사	*반생반사/NNG
반신반의	*반신반의/NNG
반지르르	*반지르르/MAG
반질반질	*반질반질/MAG
반짝반짝	*반짝반짝/MAG
받들어총	*받들어총/NNG
받아쓰기	*받아쓰기/NNG
발긋발긋	*발긋발긋/MAG
발딱발딱	*발딱발딱/MAG
발름발름	*발름발름/MAG
발본색원	*발본색원/NNG
방글방글	*방글방글/MAG
방긋방긋	*방긋방긋/MAG
방물장사	*방물장사/NNG
방성대곡	*방성대곡/NNG
방성통곡	*방성통곡/NNG
방실방실	*방실방실/MAG
방싯방싯	*방싯방싯/MAG
방약무인	*방약무인/NNG
방패막이	*방패막이/NNG
배실배실	*배실배실/MAG
배은망덕	*배은망덕/NNG
백귀야행	*백귀야행/NNG
백년해로	*백년해로/NNG
백발백중	*백발백중/NNG
백배사례	*백배사례/NNG
백배사죄	*백배사죄/NNG
백의종군	*백의종군/NNG
백일기도	*백일기도/NNG
백전백승	*백전백승/NNG
백전백패	*백전백패/NNG
백전불패	*백전불패/NNG
백절불굴	*백절불굴/NNG
백중놀이	*백중놀이/NNG
백해무익	*백해무익/NNG
뱅그르르	*뱅그르르/MAG
뱅글뱅글	*뱅글뱅글/MAG
버글버글	*버글버글/MAG
버둥버둥	*버둥버둥/MAG
버들버들	*버들버들/MAG
버럭버럭	*버럭버럭/MAG
버석버석	*버석버석/MAG
벅적벅적	*벅적벅적/MAG
번드르르	*번드르르/MAG
번들번들	*번들번들/MAG
번듯번듯	*번듯번듯/MAG
번뜩번뜩	*번뜩번뜩/MAG
번뜻번뜻	*번뜻번뜻/MAG
번죽번죽	*번죽번죽/MAG
번지르르	*번지르르/MAG
번질번질	*번질번질/MAG
번쩍번쩍	*번쩍번쩍/MAG
벌떡벌떡	*벌떡벌떡/MAG
벌럭벌럭	*벌럭벌럭/MAG
벌렁벌렁	*벌렁벌렁/MAG
벌름벌름	*벌름벌름/MAG
벌컥벌컥	*벌컥벌컥/MAG
법고놀음	*법고놀음/NNG
법고놀이	*법고놀이/NNG
벙글벙글	*벙글벙글/MAG
벤치마킹	*벤치마킹/NNG
벼락출세	*벼락출세/NNG
벼슬살이	*벼슬살이/NNG
변화막측	*변화막측/NNG
변화무쌍	*변화무쌍/NNG
병정놀이	*병정놀이/NNG
병풍상서	*병풍상서/NNG
병풍상성	*병풍상성/NNG
보국안민	*보국안민/NNG
보글보글	*보글보글/MAG
보들보들	*보들보들/MAG
보리밟기	*보리밟기/NNG
보리타작	*보리타작/NNG
보송보송	*보송보송/MAG
보슬보슬	*보슬보슬/MAG
보편타당	*보편타당/NNG
복구공사	*복구공사/NNG
복지부동	*복지부동/NNG
본척만척	*본척만척/MAG
본체만체	*본체만체/MAG
볼록볼록	*볼록볼록/MAG
봄나들이	*봄나들이/NNG
봉두난발	*봉두난발/NNG
부글부글	*부글부글/MAG
부득부득	*부득부득/MAG
부들부들	*부들부들/MAG
부릉부릉	*부릉부릉/MAG
부리부리	*부리부리/MAG
부부유별	*부부유별/NNG
부석부석	*부석부석/MAG
부숭부숭	*부숭부숭/MAG
부슬부슬	*부슬부슬/MAG
부얼부얼	*부얼부얼/MAG
부유스름	*부유스름/NNG
부자유친	*부자유친/NNG
부재모상	*부재모상/NNG
부전부전	*부전부전/MAG
부전자전	*부전자전/NNG
부정부패	*부정부패/NNG
부정풀이	*부정풀이/NNG
부지거처	*부지거처/NNG
부진부진	*부진부진/MAG
부창부수	*부창부수/NNG
부화뇌동	*부화뇌동/NNG
부화방탕	*부화방탕/NNG
북슬북슬	*북슬북슬/MAG
북실북실	*북실북실/MAG
북적북적	*북적북적/MAG
북향재배	*북향재배/NNG
분골쇄신	*분골쇄신/NNG
분기탱천	*분기탱천/NNG
분수작별	*분수작별/NNG
분신자살	*분신자살/NNG
분투노력	*분투노력/NNG
분향재배	*분향재배/NNG
불가사의	*불가사의/NNG
불긋불긋	*불긋불긋/MAG
불끈불끈	*불끈불끈/MAG
불로장생	*불로장생/NNG
불로장수	*불로장수/NNG
불룩불룩	*불룩불룩/MAG
불문곡직	*불문곡직/NNG
불쑥불쑥	*불쑥불쑥/MAG
불요불급	*불요불급/NNG
불원천리	*불원천리/NNG
불철주야	*불철주야/NNG
불편부당	*불편부당/NNG
비대발괄	*비대발괄/NNG
비뚤배뚤	*비뚤배뚤/MAG
비뚤비뚤	*비뚤비뚤/MAG
비명횡사	*비명횡사/NNG
비분강개	*비분강개/NNG
비설거지	*비설거지/NNG
비슬비슬	*비슬비슬/MAG
비슷비슷	*비슷비슷/MAG
비실비실	*비실비실/MAG
비일비재	*비일비재/NNG
비죽비죽	*비죽비죽/MAG
비쭉비쭉	*비쭉비쭉/MAG
비척비척	*비척비척/MAG
비칠비칠	*비칠비칠/MAG
비틀비틀	*비틀비틀/MAG
비황저곡	*비황저곡/NNG
빈둥빈둥	*빈둥빈둥/MAG
빙그르르	*빙그르르/MAG
빙글빙글	*빙글빙글/MAG
빙싯빙싯	*빙싯빙싯/MAG
빠꼼빠꼼	*빠꼼빠꼼/MAG
빠닥빠닥	*빠닥빠닥/MAG
빠릿빠릿	*빠릿빠릿/MAG
빠삭빠삭	*빠삭빠삭/MAG
빤들빤들	*빤들빤들/MAG
빤작빤작	*빤작빤작/MAG
빤지르르	*빤지르르/MAG
빤질빤질	*빤질빤질/MAG
빨긋빨긋	*빨긋빨긋/MAG
빼딱빼딱	*빼딱빼딱/MAG
뺀들뺀들	*뺀들뺀들/MAG
뺀질뺀질	*뺀질뺀질/MAG
뺑글뺑글	*뺑글뺑글/MAG
뻐걱뻐걱	*뻐걱뻐걱/MAG
뻐금뻐금	*뻐금뻐금/MAG
뻐끔뻐끔	*뻐끔뻐끔/MAG
뻔지르르	*뻔지르르/MAG
뻔쩍뻔쩍	*뻔쩍뻔쩍/MAG
뽀그르르	*뽀그르르/MAG
뽀득뽀득	*뽀득뽀득/MAG
뽀송뽀송	*뽀송뽀송/MAG
뾰족뾰족	*뾰족뾰족/MAG
삐걱삐걱	*삐걱삐걱/MAG
삐딱삐딱	*삐딱삐딱/MAG
삐뚤빼뚤	*삐뚤빼뚤/MAG
삐뚤삐뚤	*삐뚤삐뚤/MAG
삐악삐악	*삐악삐악/MAG
삐죽삐죽	*삐죽삐죽/MAG
삥그르르	*삥그르르/MAG
사각사각	*사각사각/MAG
사고무친	*사고무친/NNG
사락사락	*사락사락/MAG
사람대접	*사람대접/NNG
사람잡이	*사람잡이/NNG
사랑놀이	*사랑놀이/NNG
사륵사륵	*사륵사륵/MAG
사분사분	*사분사분/MAG
사분오열	*사분오열/NNG
사뿐사뿐	*사뿐사뿐/MAG
사생결단	*사생결단/NNG
사생취의	*사생취의/NNG
사세부득	*사세부득/NNG
사실무근	*사실무근/NNG
사악사악	*사악사악/MAG
사은숙배	*사은숙배/NNG
사정사정	*사정사정/NNG
사탕발림	*사탕발림/NNG
사통팔달	*사통팔달/NNG
사푼사푼	*사푼사푼/MAG
사필귀정	*사필귀정/NNG
삯바느질	*삯바느질/NNG
산대놀이	*산대놀이/NNG
산들산들	*산들산들/MAG
산뜩산뜩	*산뜩산뜩/MAG
산자수명	*산자수명/NNG
살랑살랑	*살랑살랑/MAG
살래살래	*살래살래/MAG
살레살레	*살레살레/MAG
살림살이	*살림살이/NNG
살신성인	*살신성인/NNG
삼베길쌈	*삼베길쌈/NNG
상긋방긋	*상긋방긋/MAG
상문풀이	*상문풀이/NNG
상봉하솔	*상봉하솔/NNG
상부상조	*상부상조/NNG
새근새근	*새근새근/MAG
새들새들	*새들새들/MAG
새벽동자	*새벽동자/NNG
생게망게	*생게망게/MAG
생계유지	*생계유지/NNG
생글생글	*생글생글/MAG
생긋방긋	*생긋방긋/MAG
생생화육	*생생화육/NNG
생이지지	*생이지지/NNG
생일잔치	*생일잔치/NNG
서걱서걱	*서걱서걱/MAG
서글서글	*서글서글/MAG
서성서성	*서성서성/MAG
서슴서슴	*서슴서슴/MAG
선득선득	*선득선득/MAG
선뜩선뜩	*선뜩선뜩/MAG
선뜻선뜻	*선뜻선뜻/MAG
선제공격	*선제공격/NNG
선제타격	*선제타격/NNG
설렁설렁	*설렁설렁/MAG
설레설레	*설레설레/MAG
설왕설래	*설왕설래/NNG
섬벅섬벅	*섬벅섬벅/MAG
성냥팔이	*성냥팔이/NNG
성주받이	*성주받이/NNG
성주풀이	*성주풀이/NNP
세간살이	*세간살이/NNG
세로쓰기	*세로쓰기/NNG
셋방살이	*셋방살이/NNG
소곤소곤	*소곤소곤/MAG
소금구이	*소금구이/NNG
소금절이	*소금절이/NNG
소꿉놀이	*소꿉놀이/NNG
소꿉장난	*소꿉장난/NNG
소록소록	*소록소록/MAG
소매치기	*소매치기/NNG
소복단장	*소복단장/NNG
소복소복	*소복소복/MAG
소탐대실	*소탐대실/NNG
속닥속닥	*속닥속닥/MAG
속도위반	*속도위반/NNG
속전속결	*속전속결/NNG
손님맞이	*손님맞이/NNG
손바느질	*손바느질/NNG
솔선수범	*솔선수범/NNG
송골송골	*송골송골/MAG
송구영신	*송구영신/NNG
송당송당	*송당송당/MAG
송알송알	*송알송알/MAG
수군수군	*수군수군/MAG
수런수런	*수런수런/MAG
수렴청정	*수렴청정/NNG
수리수리	*수리수리/MAG
수미일관	*수미일관/NNG
수북수북	*수북수북/MAG
수선수선	*수선수선/MAG
수수방관	*수수방관/NNG
수신제가	*수신제가/NNG
순회공연	*순회공연/NNG
술래잡기	*술래잡기/NNG
술렁술렁	*술렁술렁/MAG
숨바꼭질	*숨바꼭질/NNG
숫자풀이	*숫자풀이/NNG
숭굴숭굴	*숭굴숭굴/MAG
숭덩숭덩	*숭덩숭덩/MAG
숭얼숭얼	*숭얼숭얼/MAG
쉬엄쉬엄	*쉬엄쉬엄/MAG
스륵스륵	*스륵스륵/MAG
스멀스멀	*스멀스멀/MAG
스적스적	*스적스적/MAG
스카우트	*스카우트/NNG
스케이팅	*스케이팅/NNG
스케일링	*스케일링/NNG
스파이크	*스파이크/NNG
슬근슬근	*슬근슬근/MAG
슬라이딩	*슬라이딩/NNG
승승장구	*승승장구/NNG
시기적절	*시기적절/NNG
시끌벅적	*시끌벅적/MAG
시끌시끌	*시끌시끌/MAG
시난고난	*시난고난/MAG
시득시득	*시득시득/MAG
시들부들	*시들부들/MAG
시들시들	*시들시들/MAG
시시비비	*시시비비/NNG
시시콜콜	*시시콜콜/MAG
시원시원	*시원시원/MAG
시의적절	*시의적절/NNG
시종여일	*시종여일/NNG
시종일관	*시종일관/NNG
시집살이	*시집살이/NNG
식모살이	*식모살이/NNG
신문팔이	*신문팔이/NNG
신선놀음	*신선놀음/NNG
신세타령	*신세타령/NNG
신신당부	*신신당부/NNG
신장개업	*신장개업/NNG
신접살림	*신접살림/NNG
신체검사	*신체검사/NNG
신출귀몰	*신출귀몰/NNG
실룩실룩	*실룩실룩/MAG
실천궁행	*실천궁행/NNG
심기일전	*심기일전/NNG
심사숙고	*심사숙고/NNG
심심파적	*심심파적/NNG
심심풀이	*심심풀이/NNG
싱글벙글	*싱글벙글/MAG
싱글싱글	*싱글싱글/MAG
싱긋싱긋	*싱긋싱긋/MAG
싱숭생숭	*싱숭생숭/MAG
싸움박질	*싸움박질/NNG
싹둑싹둑	*싹둑싹둑/MAG
쌔근쌔근	*쌔근쌔근/MAG
썩둑썩둑	*썩둑썩둑/MAG
쏘곤쏘곤	*쏘곤쏘곤/MAG
쑤군쑤군	*쑤군쑤군/MAG
쑤석쑤석	*쑤석쑤석/MAG
쑥덕공론	*쑥덕공론/NNG
쑹덩쑹덩	*쑹덩쑹덩/MAG
쓱싹쓱싹	*쓱싹쓱싹/MAG
씨근벌떡	*씨근벌떡/MAG
씨근씨근	*씨근씨근/MAG
씨끌씨끌	*씨끌씨끌/MAG
씨엉씨엉	*씨엉씨엉/MAG
씩둑씩둑	*씩둑씩둑/MAG
씰룩씰룩	*씰룩씰룩/MAG
아귀다툼	*아귀다툼/NNG
아근바근	*아근바근/MAG
아기자기	*아기자기/MAG
아득바득	*아득바득/MAG
아등바등	*아등바등/MAG
아롱다롱	*아롱다롱/MAG
아롱아롱	*아롱아롱/MAG
아른아른	*아른아른/MAG
아름아름	*아름아름/MAG
아리아리	*아리아리/NNP
아릿아릿	*아릿아릿/MAG
아물아물	*아물아물/MAG
아삭아삭	*아삭아삭/MAG
아스무레	*아스무레/MAG
아슬아슬	*아슬아슬/MAG
아슴아슴	*아슴아슴/MAG
아슴푸레	*아슴푸레/MAG
아연실색	*아연실색/NNG
아옹다옹	*아옹다옹/MAG
아웅다웅	*아웅다웅/MAG
아유구용	*아유구용/NNG
아이러니	*아이러니/NNG
아작아작	*아작아작/MAG
아장아장	*아장아장/MAG
아질아질	*아질아질/MAG
아찔아찔	*아찔아찔/MAG
악다구니	*악다구니/NNG
악전고투	*악전고투/NNG
안고수비	*안고수비/NNG
안달복달	*안달복달/MAG
안분지족	*안분지족/NNG
안빈낙도	*안빈낙도/NNG
안성맞춤	*안성맞춤/NNG
안절부절	*안절부절/MAG
알근달근	*알근달근/MAG
알뜰살뜰	*알뜰살뜰/MAG
알랑알랑	*알랑알랑/MAG
알록달록	*알록달록/MAG
알쏭달쏭	*알쏭달쏭/MAG
알음알음	*알음알음/NNG
알콩달콩	*알콩달콩/MAG
암중모색	*암중모색/NNG
앙글방글	*앙글방글/MAG
앙알앙알	*앙알앙알/MAG
앞지르기	*앞지르기/NNG
애걸복걸	*애걸복걸/NNG
애리애리	*애리애리/MAG
애매모호	*애매모호/NNG
애면글면	*애면글면/MAG
애벌갈이	*애벌갈이/NNG
애옥살이	*애옥살이/NNG
애지중지	*애지중지/MAG
야간도주	*야간도주/NNG
야간작업	*야간작업/NNG
야금야금	*야금야금/MAG
야들야들	*야들야들/MAG
야리야리	*야리야리/MAG
야반도주	*야반도주/NNG
약육강식	*약육강식/NNG
얄팍얄팍	*얄팍얄팍/MAG
양자택일	*양자택일/NNG
어글어글	*어글어글/MAG
어금버금	*어금버금/MAG
어깨걸이	*어깨걸이/NNG
어깨동무	*어깨동무/NNG
어둑어둑	*어둑어둑/MAG
어둠컴컴	*어둠컴컴/MAG
어룽어룽	*어룽어룽/MAG
어른어른	*어른어른/MAG
어름어름	*어름어름/MAG
어리가리	*어리가리/NNG
어리삥삥	*어리삥삥/NNG
어리어리	*어리어리/MAG
어리장사	*어리장사/NNG
어림짐작	*어림짐작/NNG
어릿어릿	*어릿어릿/MAG
어물어물	*어물어물/MAG
어성버성	*어성버성/MAG
어슬어슬	*어슬어슬/MAG
어슴푸레	*어슴푸레/MAG
어슷비슷	*어슷비슷/MAG
어슷어슷	*어슷어슷/MAG
어여머리	*어여머리/NNG
어영부영	*어영부영/MAG
어적어적	*어적어적/MAG
어정버정	*어정버정/MAG
어정어정	*어정어정/MAG
어질어질	*어질어질/MAG
어찌어찌	*어찌어찌/MAG
어찔어찔	*어찔어찔/MAG
어청어청	*어청어청/MAG
억강부약	*억강부약/NNG
억약부강	*억약부강/NNG
언듯언듯	*언듯언듯/MAG
언뜻언뜻	*언뜻언뜻/MAG
언죽번죽	*언죽번죽/MAG
언행일치	*언행일치/NNG
얼금얼금	*얼금얼금/MAG
얼기설기	*얼기설기/MAG
얼렁뚱땅	*얼렁뚱땅/MAG
얼룩덜룩	*얼룩덜룩/MAG
얼룩얼룩	*얼룩얼룩/MAG
얼른얼른	*얼른얼른/MAG
얼키설키	*얼키설키/MAG
엄벙덤벙	*엄벙덤벙/MAG
업데이트	*업데이트/NNG
엉거주춤	*엉거주춤/MAG
엉금엉금	*엉금엉금/MAG
엉정벙정	*엉정벙정/MAG
에스코트	*에스코트/NNG
여민동락	*여민동락/NNG
여타자별	*여타자별/NNG
역정풀이	*역정풀이/NNG
역지사지	*역지사지/NNG
연날리기	*연날리기/NNG
연락부절	*연락부절/NNG
연목구어	*연목구어/NNG
연전연승	*연전연승/NNG
연중무휴	*연중무휴/NNG
영구불변	*영구불변/NNG
영생불멸	*영생불멸/NNG
영세불망	*영세불망/NNG
영원무궁	*영원무궁/NNG
영원불변	*영원불변/NNG
오그르르	*오그르르/MAG
오글오글	*오글오글/MAG
오냐오냐	*오냐오냐/IC
오늘내일	*오늘내일/NNG
오돌오돌	*오돌오돌/MAG
오돌토돌	*오돌토돌/MAG
오동포동	*오동포동/MAG
오들오들	*오들오들/MAG
오뚝오뚝	*오뚝오뚝/MAG
오락가락	*오락가락/MAG
오롱조롱	*오롱조롱/MAG
오만무례	*오만무례/NNG
오만불손	*오만불손/NNG
오매불망	*오매불망/NNG
오목조목	*오목조목/MAG
오물오물	*오물오물/MAG
오밀조밀	*오밀조밀/MAG
오바이트	*오바이트/NNG
오불관언	*오불관언/NNG
오손도손	*오손도손/MAG
오순도순	*오순도순/MAG
오슬오슬	*오슬오슬/MAG
오싹오싹	*오싹오싹/MAG
오톨도톨	*오톨도톨/MAG
옥바라지	*옥바라지/NNG
옥신각신	*옥신각신/NNG
온고지신	*온고지신/NNG
올록볼록	*올록볼록/MAG
올망졸망	*올망졸망/MAG
옴죽옴죽	*옴죽옴죽/MAG
옴짝달싹	*옴짝달싹/MAG
옴팍옴팍	*옴팍옴팍/MAG
옴폭옴폭	*옴폭옴폭/MAG
옷매무시	*옷매무시/NNG
옹기옹기	*옹기옹기/MAG
옹기종기	*옹기종기/MAG
와그르르	*와그르르/MAG
와글와글	*와글와글/MAG
와들와들	*와들와들/MAG
와락와락	*와락와락/MAG
와삭와삭	*와삭와삭/MAG
와석종신	*와석종신/NNG
와신상담	*와신상담/NNG
와짝와짝	*와짝와짝/MAG
왁자지껄	*왁자지껄/MAG
왁작왁작	*왁작왁작/MAG
완전무결	*완전무결/NNG
왈가불가	*왈가불가/NNG
왈가왈부	*왈가왈부/NNG
외강내유	*외강내유/NNG
외빈내부	*외빈내부/NNG
외손봉사	*외손봉사/NNG
외유내강	*외유내강/NNG
외화벌이	*외화벌이/NNG
요령부득	*요령부득/NNG
요리조리	*요리조리/MAG
요지부동	*요지부동/NNG
욕지거리	*욕지거리/NNG
용감무쌍	*용감무쌍/NNG
용기백배	*용기백배/NNG
우걱우걱	*우걱우걱/MAG
우걱지걱	*우걱지걱/MAG
우격다짐	*우격다짐/NNG
우글우글	*우글우글/MAG
우글쭈글	*우글쭈글/MAG
우두망찰	*우두망찰/MAG
우뚝우뚝	*우뚝우뚝/MAG
우락부락	*우락부락/MAG
우렁우렁	*우렁우렁/MAG
우물우물	*우물우물/MAG
우물쭈물	*우물쭈물/MAG
우승열패	*우승열패/NNG
우유부단	*우유부단/NNG
우적우적	*우적우적/MAG
우죽우죽	*우죽우죽/MAG
우줄우줄	*우줄우줄/MAG
우직우직	*우직우직/MAG
우쩍우쩍	*우쩍우쩍/MAG
우쭐우쭐	*우쭐우쭐/MAG
우화등선	*우화등선/NNG
욱신욱신	*욱신욱신/MAG
욱일승천	*욱일승천/NNG
울걱울걱	*울걱울걱/MAG
울고불고	*울고불고/MAG
울근불근	*울근불근/MAG
울긋불긋	*울긋불긋/MAG
울꺽울꺽	*울꺽울꺽/MAG
울뚝불뚝	*울뚝불뚝/MAG
울렁울렁	*울렁울렁/MAG
울먹울먹	*울먹울먹/MAG
울며불며	*울며불며/MAG
울컥울컥	*울컥울컥/MAG
울툭불툭	*울툭불툭/MAG
울퉁불퉁	*울퉁불퉁/MAG
움쭉달싹	*움쭉달싹/MAG
움찔움찔	*움찔움찔/MAG
움푹움푹	*움푹움푹/MAG
웅기중기	*웅기중기/MAG
웅성웅성	*웅성웅성/MAG
웅얼웅얼	*웅얼웅얼/MAG
원상회복	*원상회복/NNG
위인설관	*위인설관/NNG
위풍당당	*위풍당당/NNG
위험천만	*위험천만/NNG
유들유들	*유들유들/MAG
유리개걸	*유리개걸/NNG
유리걸식	*유리걸식/NNG
유리표박	*유리표박/NNG
유만부동	*유만부동/NNG
유명무실	*유명무실/NNG
유야무야	*유야무야/NNG
유유상종	*유유상종/NNG
유유자적	*유유자적/NNG
유일무이	*유일무이/NNG
유처취처	*유처취처/NNG
유형무형	*유형무형/NNG
으리으리	*으리으리/MAG
으슬으슬	*으슬으슬/MAG
으쓱으쓱	*으쓱으쓱/MAG
으적으적	*으적으적/MAG
은인자중	*은인자중/NNG
음독자살	*음독자살/NNG
음풍영월	*음풍영월/NNG
응급조치	*응급조치/NNG
의기소침	*의기소침/NNG
의기양양	*의기양양/NNG
의기투합	*의기투합/NNG
의사소통	*의사소통/NNG
이글이글	*이글이글/MAG
이럭저럭	*이럭저럭/MAG
이리이리	*이리이리/MAG
이리저리	*이리저리/MAG
이삭줍기	*이삭줍기/NNG
이신작칙	*이신작칙/NNG
이실직고	*이실직고/NNG
이심전심	*이심전심/NNG
이열치열	*이열치열/NNG
이이제이	*이이제이/NNG
이자택일	*이자택일/NNG
이죽이죽	*이죽이죽/MAG
이해타산	*이해타산/NNG
인기투표	*인기투표/NNG
인사치레	*인사치레/NNG
인수인계	*인수인계/NNG
인신공격	*인신공격/NNG
인신매매	*인신매매/NNG
인터셉트	*인터셉트/NNG
일거삼득	*일거삼득/NNG
일거양득	*일거양득/NNG
일구월심	*일구월심/NNG
일도양단	*일도양단/NNG
일락서산	*일락서산/NNP
일렁일렁	*일렁일렁/MAG
일망무제	*일망무제/NNG
일망타진	*일망타진/NNG
일맥상통	*일맥상통/NNG
일모도궁	*일모도궁/NNG
일모도원	*일모도원/NNG
일문일답	*일문일답/NNG
일벌백계	*일벌백계/NNG
일부종사	*일부종사/NNG
일사불란	*일사불란/NNG
일시동인	*일시동인/NNG
일자무식	*일자무식/NNG
일진일퇴	*일진일퇴/NNG
일취월장	*일취월장/NNG
일치단결	*일치단결/NNG
일필휘지	*일필휘지/NNG
일확천금	*일확천금/NNG
일희일비	*일희일비/NNG
임기응변	*임기응변/NNG
임시변통	*임시변통/NNG
입도선매	*입도선매/NNG
입산수도	*입산수도/NNG
입신양명	*입신양명/NNG
입신출세	*입신출세/NNG
입찬소리	*입찬소리/NNG
입향순속	*입향순속/NNG
자그르르	*자그르르/MAG
자근자근	*자근자근/MAG
자글자글	*자글자글/MAG
자급자족	*자급자족/NNG
자끈자끈	*자끈자끈/MAG
자늑자늑	*자늑자늑/MAG
자력갱생	*자력갱생/NNG
자리걷이	*자리걷이/NNG
자리다툼	*자리다툼/NNG
자리매김	*자리매김/NNG
자리바꿈	*자리바꿈/NNG
자리보전	*자리보전/NNG
자리싸움	*자리싸움/NNG
자릿자릿	*자릿자릿/MAG
자문자답	*자문자답/NNG
자박자박	*자박자박/MAG
자분자분	*자분자분/MAG
자수성가	*자수성가/NNG
자승자박	*자승자박/NNG
자업자득	*자업자득/NNG
자원입대	*자원입대/NNG
자유방임	*자유방임/NNG
자유자재	*자유자재/NNG
자작자작	*자작자작/MAG
자주독립	*자주독립/NNG
자중자애	*자중자애/NNG
자포자기	*자포자기/NNG
자학자습	*자학자습/NNG
자화자찬	*자화자찬/NNG
작신작신	*작신작신/MAG
작취미성	*작취미성/NNG
잔심부름	*잔심부름/NNG
잔인무도	*잔인무도/NNG
잔학무도	*잔학무도/NNG
잘강잘강	*잘강잘강/MAG
잘근잘근	*잘근잘근/MAG
잘뚝잘뚝	*잘뚝잘뚝/MAG
잘박잘박	*잘박잘박/MAG
잠복근무	*잠복근무/NNG
장공속죄	*장공속죄/NNG
재깍재깍	*재깍재깍/MAG
재깔재깔	*재깔재깔/MAG
재물재물	*재물재물/MAG
재잘재잘	*재잘재잘/MAG
쟁강쟁강	*쟁강쟁강/MAG
저릿저릿	*저릿저릿/MAG
저벅저벅	*저벅저벅/MAG
저분저분	*저분저분/MAG
적적상승	*적적상승/NNG
전도유망	*전도유망/NNG
전력투구	*전력투구/NNG
전무후무	*전무후무/NNG
전심전력	*전심전력/NNG
전쟁놀이	*전쟁놀이/NNG
전전긍긍	*전전긍긍/NNG
전전반측	*전전반측/NNG
전지전능	*전지전능/NNG
전화위복	*전화위복/NNG
절대복종	*절대복종/NNG
절뚝절뚝	*절뚝절뚝/MAG
절렁절렁	*절렁절렁/MAG
절레절레	*절레절레/MAG
절룩절룩	*절룩절룩/MAG
절차탁마	*절차탁마/NNG
절치부심	*절치부심/NNG
절컥절컥	*절컥절컥/MAG
접붙이기	*접붙이기/NNG
정년퇴직	*정년퇴직/NNG
정면충돌	*정면충돌/NNG
제기차기	*제기차기/NNG
제비뽑기	*제비뽑기/NNG
조곤조곤	*조곤조곤/MAG
조랑조랑	*조랑조랑/MAG
조령모개	*조령모개/NNG
조롱조롱	*조롱조롱/MAG
조마조마	*조마조마/MAG
조물조물	*조물조물/MAG
조반석죽	*조반석죽/NNG
조실부모	*조실부모/NNG
조심조심	*조심조심/MAG
조용조용	*조용조용/MAG
조잘조잘	*조잘조잘/MAG
조조할인	*조조할인/NNG
조촘조촘	*조촘조촘/MAG
졸금졸금	*졸금졸금/MAG
졸깃졸깃	*졸깃졸깃/MAG
졸랑졸랑	*졸랑졸랑/MAG
졸래졸래	*졸래졸래/MAG
졸망졸망	*졸망졸망/MAG
종알종알	*종알종알/MAG
좌고우면	*좌고우면/NNG
좌불안석	*좌불안석/NNG
좌왕우왕	*좌왕우왕/NNG
좌지우지	*좌지우지/NNG
좌충우돌	*좌충우돌/NNG
좌측통행	*좌측통행/NNG
주경야독	*주경야독/NNG
주렁주렁	*주렁주렁/MAG
주룩주룩	*주룩주룩/MAG
주마간산	*주마간산/NNG
주먹다짐	*주먹다짐/NNG
주뼛주뼛	*주뼛주뼛/MAG
주섬주섬	*주섬주섬/MAG
주유천하	*주유천하/NNG
주작부언	*주작부언/NNG
주저주저	*주저주저/MAG
주전부리	*주전부리/NNG
주절주절	*주절주절/MAG
주춤주춤	*주춤주춤/MAG
줄다리기	*줄다리기/NNG
줄렁줄렁	*줄렁줄렁/MAG
줄레줄레	*줄레줄레/MAG
중간보고	*중간보고/NNG
중계방송	*중계방송/NNG
중과부적	*중과부적/NNG
중도반단	*중도반단/NNG
중동무이	*중동무이/NNG
중둥무이	*중둥무이/NNG
중언부언	*중언부언/NNG
중얼중얼	*중얼중얼/MAG
쥐락펴락	*쥐락펴락/MAG
쥐불놀이	*쥐불놀이/NNG
즐풍목우	*즐풍목우/NNG
지고지상	*지고지상/NNG
지고지순	*지고지순/NNG
지근지근	*지근지근/MAG
지글지글	*지글지글/MAG
지긋지긋	*지긋지긋/MAG
지끈지끈	*지끈지끈/MAG
지딱지딱	*지딱지딱/MAG
지레짐작	*지레짐작/NNG
지리멸렬	*지리멸렬/NNG
지분지분	*지분지분/MAG
지싯지싯	*지싯지싯/MAG
지적지적	*지적지적/MAG
지지부진	*지지부진/NNG
지지지지	*지지지지/MAG
지척지척	*지척지척/MAG
지칫지칫	*지칫지칫/MAG
지피지기	*지피지기/NNG
진두지휘	*진두지휘/NNG
진득진득	*진득진득/MAG
진선진미	*진선진미/NNG
진천동지	*진천동지/NNG
진충보국	*진충보국/NNG
질겅질겅	*질겅질겅/MAG
질근질근	*질근질근/MAG
질금질금	*질금질금/MAG
질깃질깃	*질깃질깃/MAG
질척질척	*질척질척/MAG
질퍽질퍽	*질퍽질퍽/MAG
집적집적	*집적집적/MAG
징글징글	*징글징글/MAG
징역살이	*징역살이/NNG
짚신감발	*짚신감발/NNG
짜릿짜릿	*짜릿짜릿/MAG
짤깍짤깍	*짤깍짤깍/MAG
짤랑짤랑	*짤랑짤랑/MAG
짤래짤래	*짤래짤래/MAG
짤막짤막	*짤막짤막/MAG
째깍째깍	*째깍째깍/MAG
쩌렁쩌렁	*쩌렁쩌렁/MAG
쩔꺽쩔꺽	*쩔꺽쩔꺽/MAG
쩔뚝쩔뚝	*쩔뚝쩔뚝/MAG
쩔렁쩔렁	*쩔렁쩔렁/MAG
쪼글쪼글	*쪼글쪼글/MAG
쫀득쫀득	*쫀득쫀득/MAG
쫄깃쫄깃	*쫄깃쫄깃/MAG
쫄랑쫄랑	*쫄랑쫄랑/MAG
쫄래쫄래	*쫄래쫄래/MAG
쫑긋쫑긋	*쫑긋쫑긋/MAG
쭈글쭈글	*쭈글쭈글/MAG
쭈빗쭈빗	*쭈빗쭈빗/MAG
쭈뼛쭈뼛	*쭈뼛쭈뼛/MAG
쭈삣쭈삣	*쭈삣쭈삣/MAG
쭐레쭐레	*쭐레쭐레/MAG
쭝얼쭝얼	*쭝얼쭝얼/MAG
찌걱찌걱	*찌걱찌걱/MAG
찌렁찌렁	*찌렁찌렁/MAG
찌륵찌륵	*찌륵찌륵/MAG
찌릿찌릿	*찌릿찌릿/MAG
찌직찌직	*찌직찌직/MAG
찐득찐득	*찐득찐득/MAG
찔금찔금	*찔금찔금/MAG
찔깃찔깃	*찔깃찔깃/MAG
찔끔찔끔	*찔끔찔끔/MAG
차곡차곡	*차곡차곡/MAG
차근차근	*차근차근/MAG
차랑차랑	*차랑차랑/MAG
차일피일	*차일피일/MAG
찰랑찰랑	*찰랑찰랑/MAG
찰박찰박	*찰박찰박/MAG
찰싹찰싹	*찰싹찰싹/MAG
찰칵찰칵	*찰칵찰칵/MAG
창황망조	*창황망조/NNG
창황실색	*창황실색/NNG
책상다리	*책상다리/NNG
처가살이	*처가살이/NNG
처덕처덕	*처덕처덕/MAG
천만다행	*천만다행/NNG
천만부당	*천만부당/NNG
천변만화	*천변만화/NNG
천신만고	*천신만고/NNG
천야만야	*천야만야/NNG
천우신조	*천우신조/NNG
천의무봉	*천의무봉/NNG
천인공노	*천인공노/NNG
천장지구	*천장지구/NNP
천지개벽	*천지개벽/NNG
천진난만	*천진난만/NNG
천진무구	*천진무구/NNG
천차만별	*천차만별/NNG
철두철미	*철두철미/MAG
철벅철벅	*철벅철벅/MAG
철썩철썩	*철썩철썩/MAG
철컥철컥	*철컥철컥/MAG
첨벙첨벙	*첨벙첨벙/MAG
첫나들이	*첫나들이/NNG
청경우독	*청경우독/NNG
청렴결백	*청렴결백/NNG
청순가련	*청순가련/NNG
청정무구	*청정무구/NNG
초도순시	*초도순시/NNG
초롱초롱	*초롱초롱/MAG
초지일관	*초지일관/NNG
추근추근	*추근추근/MAG
추원보본	*추원보본/NNG
추적추적	*추적추적/MAG
출렁출렁	*출렁출렁/MAG
출장입상	*출장입상/NNG
충효양전	*충효양전/NNG
취사선택	*취사선택/NNG
취생몽사	*취생몽사/NNG
치국안민	*치국안민/NNG
치다꺼리	*치다꺼리/NNG
치렁치렁	*치렁치렁/MAG
치산치수	*치산치수/NNG
치지도외	*치지도외/NNG
칠전팔기	*칠전팔기/NNG
침소봉대	*침소봉대/NNG
카랑카랑	*카랑카랑/MAG
콜록콜록	*콜록콜록/MAG
콩닥콩닥	*콩닥콩닥/MAG
콩당콩당	*콩당콩당/MAG
쿨럭쿨럭	*쿨럭쿨럭/MAG
쿨렁쿨렁	*쿨렁쿨렁/MAG
쿨룩쿨룩	*쿨룩쿨룩/MAG
쿵덕쿵덕	*쿵덕쿵덕/MAG
쿵쾅쿵쾅	*쿵쾅쿵쾅/MAG
크렁크렁	*크렁크렁/MAG
클로즈업	*클로즈업/NNG
큼직큼직	*큼직큼직/MAG
키득키득	*키득키득/MAG
키들키들	*키들키들/MAG
타닥타닥	*타닥타닥/MAG
타달타달	*타달타달/MAG
타박타박	*타박타박/MAG
타향살이	*타향살이/NNG
탁상공론	*탁상공론/NNG
태연자약	*태연자약/NNG
탱글탱글	*탱글탱글/MAG
터덕터덕	*터덕터덕/MAG
터덜터덜	*터덜터덜/MAG
터벅터벅	*터벅터벅/MAG
터벌터벌	*터벌터벌/MAG
털럭털럭	*털럭털럭/MAG
털레털레	*털레털레/MAG
텀벙텀벙	*텀벙텀벙/MAG
토막살이	*토막살이/NNG
토실토실	*토실토실/MAG
투닥투닥	*투닥투닥/MAG
투덕투덕	*투덕투덕/MAG
투덜투덜	*투덜투덜/MAG
투신자살	*투신자살/NNG
투실투실	*투실투실/MAG
투필성자	*투필성자/NNG
투현질능	*투현질능/NNG
툼벙툼벙	*툼벙툼벙/MAG
트레머리	*트레머리/NNG
트레이드	*트레이드/NNG
특립독행	*특립독행/NNG
특필대서	*특필대서/NNG
틀바느질	*틀바느질/NNG
티격태격	*티격태격/MAG
파닥파닥	*파닥파닥/MAG
파들파들	*파들파들/MAG
파란만장	*파란만장/NNG
파릇파릇	*파릇파릇/MAG
파사현정	*파사현정/NNG
파삭파삭	*파삭파삭/MAG
파안대소	*파안대소/NNG
팔딱팔딱	*팔딱팔딱/MAG
팔랑팔랑	*팔랑팔랑/MAG
팔짝팔짝	*팔짝팔짝/MAG
패가망신	*패가망신/NNG
팽그르르	*팽그르르/MAG
팽이치기	*팽이치기/NNG
퍼덕퍼덕	*퍼덕퍼덕/MAG
퍼뜩퍼뜩	*퍼뜩퍼뜩/MAG
퍼석퍼석	*퍼석퍼석/MAG
펀둥펀둥	*펀둥펀둥/MAG
펄떡펄떡	*펄떡펄떡/MAG
펄럭펄럭	*펄럭펄럭/MAG
펄쩍펄쩍	*펄쩍펄쩍/MAG
페인트칠	*페인트칠/NNG
평온무사	*평온무사/NNG
포근포근	*포근포근/MAG
포동포동	*포동포동/MAG
포복절도	*포복절도/NNG
폭신폭신	*폭신폭신/MAG
폴짝폴짝	*폴짝폴짝/MAG
퐁당퐁당	*퐁당퐁당/NNP
표리부동	*표리부동/NNG
표리일체	*표리일체/NNG
푸근푸근	*푸근푸근/MAG
푸닥거리	*푸닥거리/NNG
푸득푸득	*푸득푸득/MAG
푸들푸들	*푸들푸들/MAG
푸르딩딩	*푸르딩딩/MAG
푸릇푸릇	*푸릇푸릇/MAG
푸석푸석	*푸석푸석/MAG
푸슬푸슬	*푸슬푸슬/MAG
푸실푸실	*푸실푸실/MAG
푹신푹신	*푹신푹신/MAG
풀썩풀썩	*풀썩풀썩/MAG
풀쩍풀쩍	*풀쩍풀쩍/MAG
풍광명미	*풍광명미/NNG
풍덩풍덩	*풍덩풍덩/MAG
풍비박산	*풍비박산/NNG
풍성풍성	*풍성풍성/MAG
풍우대작	*풍우대작/NNG
풍찬노숙	*풍찬노숙/NNG
플레이스	*플레이스/NNG
피골상접	*피골상접/NNG
피난살이	*피난살이/NNG
피둥피둥	*피둥피둥/MAG
피식피식	*피식피식/MAG
핑그르르	*핑그르르/MAG
하늘하늘	*하늘하늘/MAG
하들하들	*하들하들/MAG
하박하박	*하박하박/MAG
학수고대	*학수고대/NNG
학이지지	*학이지지/NNG
한들한들	*한들한들/MAG
할끔할끔	*할끔할끔/MAG
할랑할랑	*할랑할랑/MAG
함구무언	*함구무언/NNG
해괴망측	*해괴망측/NNG
해로동혈	*해로동혈/NNG
해바라기	*해바라기/NNG
해죽해죽	*해죽해죽/MAG
행랑살이	*행랑살이/NNG
행방불명	*행방불명/NNG
허겁지겁	*허겁지겁/MAG
허덕지덕	*허덕지덕/MAG
허덕허덕	*허덕허덕/MAG
허둥지둥	*허둥지둥/MAG
허둥허둥	*허둥허둥/MAG
허드렛일	*허드렛일/NNG
허례허식	*허례허식/NNG
허물허물	*허물허물/MAG
허송세월	*허송세월/NNG
허심탄회	*허심탄회/NNG
허위단심	*허위단심/NNG
허장성세	*허장성세/NNG
허전허전	*허전허전/MAG
허정허정	*허정허정/MAG
허청허청	*허청허청/MAG
허튼수작	*허튼수작/NNG
헐떡헐떡	*헐떡헐떡/MAG
헐렁헐렁	*헐렁헐렁/MAG
헐레벌떡	*헐레벌떡/MAG
헤실헤실	*헤실헤실/MAG
현지답사	*현지답사/NNG
호가호위	*호가호위/NNG
호락호락	*호락호락/MAG
호령호령	*호령호령/NNG
호리호리	*호리호리/MAG
호미씻기	*호미씻기/NNG
호미씻이	*호미씻이/NNG
호사다마	*호사다마/NNG
호시탐탐	*호시탐탐/NNG
호언장담	*호언장담/NNG
호의호식	*호의호식/NNG
호천망극	*호천망극/NNG
호형호제	*호형호제/NNG
혹세무민	*혹세무민/NNG
혼비백산	*혼비백산/NNG
혼자소리	*혼자소리/NNG
혼잣소리	*혼잣소리/NNG
홀딱홀딱	*홀딱홀딱/MAG
홀랑홀랑	*홀랑홀랑/MAG
홀짝홀짝	*홀짝홀짝/MAG
화끈화끈	*화끈화끈/MAG
화민성속	*화민성속/NNG
확고부동	*확고부동/NNG
환갑잔치	*환갑잔치/NNG
환골탈태	*환골탈태/NNG
환난상휼	*환난상휼/NNG
환호작약	*환호작약/NNG
활랑활랑	*활랑활랑/MAG
황송무지	*황송무지/NNG
회똑회똑	*회똑회똑/MAG
횡설수설	*횡설수설/NNG
횡행천하	*횡행천하/NNG
후끈후끈	*후끈후끈/MAG
후둑후둑	*후둑후둑/MAG
후들후들	*후들후들/MAG
후룩후룩	*후룩후룩/MAG
후리후리	*후리후리/MAG
후안무치	*후안무치/NNG
후회막급	*후회막급/NNG
후회막심	*후회막심/NNG
훌떡훌떡	*훌떡훌떡/MAG
훌렁훌렁	*훌렁훌렁/MAG
훌쩍훌쩍	*훌쩍훌쩍/MAG
휘딱휘딱	*휘딱휘딱/MAG
휘적휘적	*휘적휘적/MAG
휘청휘청	*휘청휘청/MAG
흐늘흐늘	*흐늘흐늘/MAG
흐득흐득	*흐득흐득/MAG
흐리마리	*흐리마리/MAG
흐리멍텅	*흐리멍텅/MAG
흐물흐물	*흐물흐물/MAG
흐슬부슬	*흐슬부슬/MAG
흐지부지	*흐지부지/MAG
흔들흔들	*흔들흔들/MAG
흔전만전	*흔전만전/MAG
흘금흘금	*흘금흘금/MAG
흘깃흘깃	*흘깃흘깃/MAG
흘끔흘끔	*흘끔흘끔/MAG
흘낏흘낏	*흘낏흘낏/MAG
흠칫흠칫	*흠칫흠칫/MAG
흥얼흥얼	*흥얼흥얼/MAG
흥청망청	*흥청망청/MAG
흥청흥청	*흥청흥청/MAG
희끔희끔	*희끔희끔/MAG
희끗희끗	*희끗희끗/MAG
희뜩희뜩	*희뜩희뜩/MAG
희치희치	*희치희치/MAG
희희낙락	*희희낙락/NNG
히물히물	*히물히물/MAG
히죽히죽	*히죽히죽/MAG
히쭉히쭉	*히쭉히쭉/MAG
힐금힐금	*힐금힐금/MAG
힐끔힐끔	*힐끔힐끔/MAG
힐끗힐끗	*힐끗힐끗/MAG
가드락	*가드락/NNG
가르랑	*가르랑/MAG
가부좌	*가부좌/NNG
가일층	*가일층/MAG
가짓말	*가짓말/NNG
가환부	*가환부/NNG
간드랑	*간드랑/MAG
간소화	*간소화/NNG
갈갈이	*갈갈이/NNG
갈걷이	*갈걷이/NNG
갈무리	*갈무리/NNG
감침질	*감침질/NNG
강다짐	*강다짐/NNG
강행군	*강행군/NNG
개사초	*개사초/NNG
개소리	*개소리/NNG
개수작	*개수작/NNG
개영역	*개영역/NNG
개제주	*개제주/NNG
개죽음	*개죽음/NNG
개폐문	*개폐문/NNG
객소리	*객소리/NNG
갸우뚱	*갸우뚱/MAG
거북점	*거북점/NNG
거짓말	*거짓말/NNG
건삶이	*건삶이/NNG
검인정	*검인정/NNG
겉발림	*겉발림/NNG
겉치레	*겉치레/NNG
겉치장	*겉치장/NNG
게을리	*게을리/MAG
게트림	*게트림/NNG
경착륙	*경착륙/NNG
고갯짓	*고갯짓/NNG
고려장	*고려장/NNG
고로롱	*고로롱/NNG
고사당	*고사당/NNG
고수레	*고수레/NNG
고종명	*고종명/NNG
곤두질	*곤두질/NNG
곤드레	*곤드레/MAG
골막이	*골막이/NNG
곰지락	*곰지락/MAG
곱하기	*곱하기/NNG
공놀이	*공놀이/NNG
공매도	*공매도/NNG
공염불	*공염불/NNG
공진화	*공진화/NNG
공치사	*공치사/NNG
과학화	*과학화/NNG
광범위	*광범위/NNG
구군복	*구군복/NNG
구시렁	*구시렁/MAG
구조화	*구조화/NNG
국민장	*국민장/NNG
군소리	*군소리/NNG
귀동냥	*귀동냥/NNG
귀엣말	*귀엣말/NNG
귓속말	*귓속말/NNG
그럴싸	*그럴싸/NNG
근저당	*근저당/NNG
글공부	*글공부/NNG
글짓기	*글짓기/NNG
금도금	*금도금/NNG
급강하	*급강하/NNG
급반등	*급반등/NNG
급부상	*급부상/NNG
급상승	*급상승/NNG
급선회	*급선회/NNG
급성장	*급성장/NNG
급신장	*급신장/NNG
급전환	*급전환/NNG
급정거	*급정거/NNG
급정지	*급정지/NNG
급제동	*급제동/NNG
급진전	*급진전/NNG
급출발	*급출발/NNG
급팽창	*급팽창/NNG
기름칠	*기름칠/NNG
기우뚱	*기우뚱/MAG
기지개	*기지개/NNG
긴소리	*긴소리/NNG
길동무	*길동무/NNG
길양식	*길양식/NNG
까르르	*까르르/MAG
까르륵	*까르륵/MAG
까시시	*까시시/MAG
깨드득	*깨드득/MAG
꺾꽂이	*꺾꽂이/NNG
꼬꼬댁	*꼬꼬댁/MAG
꼬르륵	*꼬르륵/MAG
꼬부랑	*꼬부랑/NNG
꽃구경	*꽃구경/NNG
꽃꽂이	*꽃꽂이/NNG
꽃놀이	*꽃놀이/NNG
꽃단장	*꽃단장/NNG
꽃모종	*꽃모종/NNG
꽈르릉	*꽈르릉/MAG
꾸르르	*꾸르르/MAG
꾸르륵	*꾸르륵/MAG
꾸지람	*꾸지람/NNG
꿈지럭	*꿈지럭/MAG
끝내기	*끝내기/NNG
끝막음	*끝막음/NNG
끝손질	*끝손질/NNG
나눗셈	*나눗셈/NNG
나들이	*나들이/NNG
낙성식	*낙성식/NNG
난반사	*난반사/NNG
날갯짓	*날갯짓/NNG
날받이	*날받이/NNG
날치기	*날치기/NNG
남우세	*남우세/NNG
낮거리	*낮거리/NNG
낯가림	*낯가림/NNG
내림굿	*내림굿/NNG
내주장	*내주장/NNG
냉수욕	*냉수욕/NNG
넋두리	*넋두리/NNG
널뛰기	*널뛰기/NNG
노가리	*노가리/NNG
논갈이	*논갈이/NNG
논농사	*논농사/NNG
논두렁	*논두렁/NNG
논매기	*논매기/NNG
농사일	*농사일/NNG
눈가림	*눈가림/NNG
눈대중	*눈대중/NNG
눈속임	*눈속임/NNG
눈싸움	*눈싸움/NNG
눈어림	*눈어림/NNG
눈요기	*눈요기/NNG
눈인사	*눈인사/NNG
눈짐작	*눈짐작/NNG
늙으막	*늙으막/NNG
다다닥	*다다닥/MAG
다리쉼	*다리쉼/NNG
다림질	*다림질/NNG
다릿짓	*다릿짓/NNG
다이빙	*다이빙/NNG
단근질	*단근질/NNG
달가닥	*달가닥/MAG
달거리	*달거리/NNG
달그락	*달그락/MAG
달리기	*달리기/NNG
달맞이	*달맞이/NNG
달음질	*달음질/NNG
닭싸움	*닭싸움/NNG
담금질	*담금질/NNG
대거리	*대거리/NNG
대물림	*대물림/NNG
더덩실	*더덩실/MAG
더하기	*더하기/NNG
던지기	*던지기/NNG
덜거덕	*덜거덕/MAG
덜그럭	*덜그럭/MAG
덜커덕	*덜커덕/MAG
덜커덩	*덜커덩/MAG
덜퍼덕	*덜퍼덕/MAG
덧거리	*덧거리/NNG
덩더꿍	*덩더꿍/MAG
데이트	*데이트/NNG
뎅그렁	*뎅그렁/MAG
도두룩	*도두룩/MAG
도리기	*도리기/NNP
도리반	*도리반/NNG
도움말	*도움말/NNG
독차지	*독차지/NNG
돈놀이	*돈놀이/NNG
돈벌이	*돈벌이/NNG
돈세탁	*돈세탁/NNG
돈치기	*돈치기/NNG
돈타령	*돈타령/NNG
돌맞이	*돌맞이/NNG
돌싸움	*돌싸움/NNG
돌잡이	*돌잡이/NNG
돌치기	*돌치기/NNG
동막이	*동막이/NNG
동부인	*동부인/NNG
동안거	*동안거/NNG
되넘기	*되넘기/VV
되새김	*되새김/NNG
되생각	*되생각/NNG
되풀이	*되풀이/NNG
두둥실	*두둥실/MAG
둑막이	*둑막이/NNG
뒤범벅	*뒤범벅/NNG
뒤숭숭	*뒤숭숭/MAG
뒤스럭	*뒤스럭/NNG
뒤처리	*뒤처리/NNG
뒤치락	*뒤치락/MAG
뒤풀이	*뒤풀이/NNG
뒷갈망	*뒷갈망/NNG
뒷감당	*뒷감당/NNG
뒷거래	*뒷거래/NNG
뒷걸음	*뒷걸음/NNG
뒷결박	*뒷결박/NNG
뒷공론	*뒷공론/NNG
뒷받침	*뒷받침/NNG
뒷소리	*뒷소리/NNG
뒷수발	*뒷수발/NNG
뒷수습	*뒷수습/NNG
뒷정리	*뒷정리/NNG
뒷조사	*뒷조사/NNG
드라이	*드라이/NNG
드르렁	*드르렁/MAG
드르르	*드르르/MAG
드르륵	*드르륵/MAG
드르릉	*드르릉/MAG
드리블	*드리블/NNG
드잡이	*드잡이/NNG
드팀전	*드팀전/NNG
들까불	*들까불/VV
들놀이	*들놀이/NNG
등용문	*등용문/NNG
등퇴장	*등퇴장/NNG
디자인	*디자인/NNG
따다닥	*따다닥/MAG
따르륵	*따르륵/MAG
따르릉	*따르릉/MAG
딴살림	*딴살림/NNG
딴생각	*딴생각/NNG
딴소리	*딴소리/NNG
딸가닥	*딸가닥/MAG
딸그락	*딸그락/MAG
땅까불	*땅까불/NNG
때밀이	*때밀이/NNG
땔나무	*땔나무/NNG
떼몰이	*떼몰이/NNG
떼죽음	*떼죽음/NNG
뚜루룩	*뚜루룩/MAG
뜀박질	*뜀박질/NNG
뜸베질	*뜸베질/NNG
뜻매김	*뜻매김/NNG
뜻풀이	*뜻풀이/NNG
마무리	*마무리/NNG
마사지	*마사지/NNG
마스터	*마스터/NNG
막노동	*막노동/NNG
막벌이	*막벌이/NNG
만공산	*만공산/NNG
말다툼	*말다툼/NNG
말대꾸	*말대꾸/NNG
말대답	*말대답/NNG
말동무	*말동무/NNG
말막음	*말막음/NNG
말수작	*말수작/NNG
말싸움	*말싸움/NNG
말씨름	*말씨름/NNG
말장난	*말장난/NNG
말전주	*말전주/NNG
말조심	*말조심/NNG
말참견	*말참견/NNG
말참례	*말참례/NNG
말타기	*말타기/NNG
맞고소	*맞고소/NNG
맞교환	*맞교환/NNG
맞대결	*맞대결/NNG
맞대꾸	*맞대꾸/NNG
맞대답	*맞대답/NNG
맞대면	*맞대면/NNG
맞대응	*맞대응/NNG
맞벌이	*맞벌이/NNG
맞상대	*맞상대/NNG
매무시	*매무시/NNG
매사냥	*매사냥/NNG
매타작	*매타작/NNG
맴돌이	*맴돌이/NNG
맹공격	*맹공격/NNG
맹비난	*맹비난/NNG
맹연습	*맹연습/NNG
맹추격	*맹추격/NNG
맹활약	*맹활약/NNG
맹훈련	*맹훈련/NNG
면무식	*면무식/NNG
모내기	*모내기/NNG
모심기	*모심기/NNG
모자리	*모자리/NNG
모찌기	*모찌기/NNG
몰상식	*몰상식/NNG
몰염치	*몰염치/NNG
몰이해	*몰이해/NNG
몰인격	*몰인격/NNG
몰인정	*몰인정/NNG
몰지각	*몰지각/NNG
몰취미	*몰취미/NNG
몸가축	*몸가축/NNG
몸놀림	*몸놀림/NNG
몸단장	*몸단장/NNG
몸보신	*몸보신/NNG
몸부림	*몸부림/NNG
몸수색	*몸수색/NNG
몸싸움	*몸싸움/NNG
몸조리	*몸조리/NNG
몸조심	*몸조심/NNG
몸차림	*몸차림/NNG
몸치장	*몸치장/NNG
못자리	*못자리/NNG
무꾸리	*무꾸리/NNG
무두질	*무두질/NNG
무사상	*무사상/NNG
무소용	*무소용/NNG
무조건	*무조건/MAG
무진장	*무진장/NNG
무한대	*무한대/NNG
문단속	*문단속/NNG
물갈이	*물갈이/NNG
물놀이	*물놀이/NNG
물막이	*물막이/NNG
물세탁	*물세탁/NNG
물싸움	*물싸움/NNG
물장난	*물장난/NNG
물장사	*물장사/NNG
미끄덩	*미끄덩/MAG
미장일	*미장일/NNG
미증유	*미증유/NNG
민영화	*민영화/NNG
민주화	*민주화/NNG
밀거래	*밀거래/NNG
밀도살	*밀도살/NNG
밀매음	*밀매음/NNG
밀무역	*밀무역/NNG
밀반입	*밀반입/NNG
밀반죽	*밀반죽/NNG
밀반출	*밀반출/NNG
밀수입	*밀수입/NNG
밀수출	*밀수출/NNG
밀입국	*밀입국/NNG
밑거름	*밑거름/NNG
밑받침	*밑받침/NNG
바느질	*바느질/NNG
바드득	*바드득/MAG
바르르	*바르르/MAG
바스락	*바스락/MAG
바스스	*바스스/MAG
바운드	*바운드/NNG
바지런	*바지런/NNG
박음질	*박음질/NNG
박치기	*박치기/NNG
반승낙	*반승낙/NNG
반올림	*반올림/NNG
반죽음	*반죽음/NNG
반지레	*반지레/MAG
반타작	*반타작/NNG
반투명	*반투명/NNG
반허락	*반허락/NNG
발그레	*발그레/MAG
발놀림	*발놀림/NNG
발돋움	*발돋움/NNG
발라당	*발라당/MAG
발밀이	*발밀이/NNP
밥걱정	*밥걱정/NNG
밥벌이	*밥벌이/NNG
밥투정	*밥투정/NNG
방그레	*방그레/MAG
방시레	*방시레/MAG
밭갈이	*밭갈이/NNG
밭농사	*밭농사/NNG
밭매기	*밭매기/NNG
배밀이	*배밀이/NNG
배앓이	*배앓이/NNG
백병전	*백병전/NNG
백스윙	*백스윙/NNG
뱃놀이	*뱃놀이/NNG
뱃멀미	*뱃멀미/NNG
뱅시레	*뱅시레/MAG
버르르	*버르르/MAG
버스럭	*버스럭/MAG
벌러덩	*벌러덩/MAG
법공양	*법공양/NNG
벼농사	*벼농사/NNG
변성명	*변성명/NNG
별소리	*별소리/NNG
별신굿	*별신굿/NNG
별입시	*별입시/NNG
병간호	*병간호/NNG
병구완	*병구완/NNG
병문안	*병문안/NNG
병조림	*병조림/NNG
보르르	*보르르/MAG
보리풀	*보리풀/NNG
보비위	*보비위/NNG
보스스	*보스스/MAG
보이콧	*보이콧/NNG
복상사	*복상사/NNG
본격화	*본격화/NNG
볼가심	*볼가심/NNG
봄갈이	*봄갈이/NNG
봄맞이	*봄맞이/NNG
봉제사	*봉제사/NNG
부동심	*부동심/NNG
부드득	*부드득/MAG
부득이	*부득이/MAG
부르르	*부르르/MAG
부르릉	*부르릉/MAG
부스럭	*부스럭/MAG
부스스	*부스스/MAG
부시럭	*부시럭/MAG
부시시	*부시시/MAG
부엌일	*부엌일/NNG
부익부	*부익부/NNG
부전승	*부전승/NNG
부지런	*부지런/NNG
부지직	*부지직/MAG
분갈이	*분갈이/NNG
분단장	*분단장/NNG
분세수	*분세수/NNG
분풀이	*분풀이/NNG
불가능	*불가능/NNG
불가해	*불가해/NNG
불계승	*불계승/NNG
불계패	*불계패/NNG
불구경	*불구경/NNG
불규칙	*불규칙/NNG
불균형	*불균형/NNG
불놀이	*불놀이/NNG
불상용	*불상용/NNG
불성실	*불성실/NNG
불세출	*불세출/NNG
불소급	*불소급/NNG
불시착	*불시착/NNG
불장난	*불장난/NNG
불조심	*불조심/NNG
불투명	*불투명/NNG
불호령	*불호령/NNG
브리핑	*브리핑/NNG
블로킹	*블로킹/NNG
비난수	*비난수/NNG
비누칠	*비누칠/NNG
비아냥	*비아냥/NNG
빈익빈	*빈익빈/NNG
빚놀이	*빚놀이/NNG
빚보증	*빚보증/NNG
빚잔치	*빚잔치/NNG
빚추심	*빚추심/NNG
빠드득	*빠드득/MAG
뻥튀기	*뻥튀기/NNG
뽀그르	*뽀그르/MAG
뽀도독	*뽀도독/MAG
뽀드득	*뽀드득/MAG
뿌드드	*뿌드드/NNG
뿌드득	*뿌드득/MAG
뿌르르	*뿌르르/MAG
뿌지지	*뿌지지/MAG
뿌지직	*뿌지직/MAG
쀼루퉁	*쀼루퉁/MAG
사르락	*사르락/MAG
사르륵	*사르륵/MAG
사이비	*사이비/NNG
사자후	*사자후/NNG
사재기	*사재기/NNG
사회장	*사회장/NNG
산업화	*산업화/NNG
살막이	*살막이/NNG
살보시	*살보시/NNG
살풀이	*살풀이/NNG
살풍경	*살풍경/NNG
삼간택	*삼간택/NNG
삼등분	*삼등분/NNG
삼림욕	*삼림욕/NNG
삼모작	*삼모작/NNG
상우례	*상우례/NNG
새김질	*새김질/NNG
새벽밥	*새벽밥/NNG
새벽질	*새벽질/NNG
새살림	*새살림/NNG
새치기	*새치기/NNG
생그레	*생그레/MAG
서비스	*서비스/NNG
서양화	*서양화/NNG
선문답	*선문답/NNG
선소리	*선소리/NNG
설거지	*설거지/NNG
설맞이	*설맞이/NNG
성육신	*성육신/NNG
성추행	*성추행/NNG
성폭행	*성폭행/NNG
성희롱	*성희롱/NNG
세마치	*세마치/NNG
세일배	*세일배/NNG
소개팅	*소개팅/NNG
소겨리	*소겨리/NNG
소몰이	*소몰이/NNG
속다짐	*속다짐/NNG
속생각	*속생각/NNG
속앓이	*속앓이/NNG
속짐작	*속짐작/NNG
속풀이	*속풀이/NNG
손놀림	*손놀림/NNG
손동작	*손동작/NNG
손빨래	*손빨래/NNG
손세탁	*손세탁/NNG
손장난	*손장난/NNG
손찌검	*손찌검/NNG
수소문	*수소문/NNG
수인사	*수인사/NNG
수자리	*수자리/NNG
순매도	*순매도/NNG
술대접	*술대접/NNG
술장사	*술장사/NNG
술주정	*술주정/NNG
술추렴	*술추렴/NNG
술타령	*술타령/NNG
숨쉬기	*숨쉬기/NNG
스르륵	*스르륵/MAG
스매시	*스매시/NNG
스매싱	*스매싱/NNG
스케치	*스케치/NNG
스크랩	*스크랩/NNG
승강이	*승강이/NNG
승하차	*승하차/NNG
시가전	*시가전/NNG
시새움	*시새움/NNG
시운전	*시운전/NNG
신소리	*신소리/NNG
신트림	*신트림/NNG
실뜨기	*실뜨기/NNG
실랑이	*실랑이/NNG
실토정	*실토정/NNG
심부름	*심부름/NNG
심호흡	*심호흡/NNG
싱그레	*싱그레/MAG
싹쓸이	*싹쓸이/NNG
쌈박질	*쌈박질/NNG
쌍그레	*쌍그레/MAG
쓰레질	*쓰레질/NNG
쓴소리	*쓴소리/NNG
씁쓰레	*씁쓰레/MAG
씨내리	*씨내리/NNG
씨붙임	*씨붙임/NNG
아기작	*아기작/MAG
아드득	*아드득/MAG
아랑곳	*아랑곳/NNG
아리송	*아리송/MAG
아리숭	*아리숭/MAG
아사삭	*아사삭/MAG
아지직	*아지직/MAG
악선전	*악선전/NNG
안주장	*안주장/NNG
알받이	*알받이/NNG
암거래	*암거래/NNG
암매장	*암매장/NNG
앙감질	*앙감질/NNG
앙갚음	*앙갚음/NNG
앞가림	*앞가림/NNG
액막이	*액막이/NNG
액풀이	*액풀이/NNG
야바위	*야바위/NNG
약시중	*약시중/NNG
약장사	*약장사/NNG
양걸침	*양걸침/NNG
양치기	*양치기/NNG
어깻짓	*어깻짓/NNG
어리광	*어리광/NNG
어물쩍	*어물쩍/MAG
어벌쩡	*어벌쩡/MAG
어스름	*어스름/NNG
어슬렁	*어슬렁/MAG
어중간	*어중간/NNG
얼갈이	*얼갈이/NNG
엄벙뗑	*엄벙뗑/MAG
에누리	*에누리/NNG
역부족	*역부족/NNG
역선전	*역선전/NNG
역수입	*역수입/NNG
역수출	*역수출/NNG
역이용	*역이용/NNG
역전승	*역전승/NNG
역전패	*역전패/NNG
역추적	*역추적/NNG
역회전	*역회전/NNG
연싸움	*연싸움/NNG
연착륙	*연착륙/NNG
열처리	*열처리/NNG
엿치기	*엿치기/NNG
영성체	*영성체/NNG
영양식	*영양식/NNG
영이별	*영이별/NNG
예의관	*예의관/NNG
오도독	*오도독/MAG
오동통	*오동통/MAG
오로지	*오로지/MAG
오르르	*오르르/MAG
오모작	*오모작/NNG
오소소	*오소소/MAG
오스스	*오스스/MAG
옥살이	*옥살이/NNG
옴나위	*옴나위/NNG
옷사치	*옷사치/NNG
옷차림	*옷차림/NNG
옹알이	*옹알이/NNG
와그작	*와그작/MAG
와닥닥	*와닥닥/MAG
와당탕	*와당탕/MAG
와드득	*와드득/MAG
와르르	*와르르/MAG
와르릉	*와르릉/MAG
와장창	*와장창/MAG
와지끈	*와지끈/MAG
왈가닥	*왈가닥/NNG
왈카닥	*왈카닥/MAG
외얽이	*외얽이/NNG
욕지기	*욕지기/NNG
용솟음	*용솟음/NNG
용트림	*용트림/NNG
용틀임	*용틀임/NNG
우당탕	*우당탕/MAG
우두둑	*우두둑/MAG
우루루	*우루루/MAG
우르르	*우르르/MAG
우르릉	*우르릉/MAG
우물쩍	*우물쩍/MAG
우수수	*우수수/MAG
우중충	*우중충/MAG
우지끈	*우지끈/MAG
우지직	*우지직/MAG
우회전	*우회전/NNG
웃거름	*웃거름/NNG
위세척	*위세척/NNG
유기한	*유기한/NNG
유리화	*유리화/NNG
유의미	*유의미/NNG
윷놀이	*윷놀이/NNG
으드득	*으드득/MAG
으르렁	*으르렁/MAG
으르릉	*으르릉/MAG
으스름	*으스름/NNG
으스스	*으스스/MAG
으시시	*으시시/MAG
은도금	*은도금/NNG
의무화	*의무화/NNG
이간질	*이간질/NNG
이등분	*이등분/NNG
이모작	*이모작/NNG
이바지	*이바지/NNG
이야기	*이야기/NNG
이착륙	*이착륙/NNG
익반죽	*익반죽/NNG
인기척	*인기척/NNG
인터뷰	*인터뷰/NNG
일광욕	*일광욕/NNG
일단락	*일단락/NNG
임대차	*임대차/NNG
입가심	*입가심/NNG
입다짐	*입다짐/NNG
입막음	*입막음/NNG
입맞춤	*입맞춤/NNG
입발림	*입발림/NNG
입살이	*입살이/NNG
입속말	*입속말/NNG
입씨름	*입씨름/NNG
입출력	*입출력/NNG
입후보	*입후보/NNG
자드락	*자드락/NNG
자르르	*자르르/MAG
자맥질	*자맥질/NNG
자부담	*자부담/NNG
자연사	*자연사/NNG
자율화	*자율화/NNG
자치기	*자치기/NNG
잔걱정	*잔걱정/NNG
잔기침	*잔기침/NNG
잔사설	*잔사설/NNG
잔소리	*잔소리/NNG
잔손질	*잔손질/NNG
잘그락	*잘그락/MAG
잠꼬대	*잠꼬대/NNG
잠자리	*잠자리/NNG
잠투정	*잠투정/NNG
잡도리	*잡도리/NNG
장맞이	*장맞이/NNG
장원례	*장원례/NNG
장치기	*장치기/NNG
장탄식	*장탄식/NNG
재까닥	*재까닥/MAG
재채기	*재채기/NNG
재판정	*재판정/NNG
쟁그랑	*쟁그랑/MAG
쟁탈전	*쟁탈전/NNG
저지레	*저지레/NNG
적대시	*적대시/NNG
전통화	*전통화/NNG
절거덕	*절거덕/MAG
절그렁	*절그렁/MAG
점치기	*점치기/NNG
접붙이	*접붙이/VV
접빈객	*접빈객/NNG
정남향	*정남향/NNG
정반대	*정반대/NNG
정북향	*정북향/NNG
젖동냥	*젖동냥/NNG
젖몸살	*젖몸살/NNG
제구실	*제구실/NNG
제꺼덕	*제꺼덕/MAG
제백사	*제백사/NNG
제조사	*제조사/NNG
조그맣	*조그맣/VA
조금치	*조금치/NNG
조르르	*조르르/MAG
조바꿈	*조바꿈/NNG
조바심	*조바심/NNG
종경도	*종경도/NNG
종노릇	*종노릇/NNG
종살이	*종살이/NNG
좌르르	*좌르르/MAG
좌르륵	*좌르륵/MAG
좌회전	*좌회전/NNG
주루룩	*주루룩/MAG
주르르	*주르르/MAG
주르륵	*주르륵/MAG
주정차	*주정차/NNG
주판셈	*주판셈/NNG
줄넘기	*줄넘기/NNG
줄달음	*줄달음/NNG
줄타기	*줄타기/NNG
중노릇	*중노릇/NNG
중무장	*중무장/NNG
중요시	*중요시/NNG
중징계	*중징계/NNG
지다위	*지다위/NNG
지르르	*지르르/MAG
지저귀	*지저귀/VV
지천명	*지천명/NNG
지청구	*지청구/NNG
직거래	*직거래/NNG
직수입	*직수입/NNG
직수출	*직수출/NNG
진일보	*진일보/NNG
질식사	*질식사/NNG
집대성	*집대성/NNG
집들이	*집들이/NNG
집수리	*집수리/NNG
집짓기	*집짓기/NNG
짓거리	*짓거리/NNG
짜깁기	*짜깁기/NNG
짜르르	*짜르르/MAG
짝사랑	*짝사랑/NNG
짝짜꿍	*짝짜꿍/NNG
짤그락	*짤그락/MAG
짤까당	*짤까당/MAG
쨍그랑	*쨍그랑/MAG
쪼르르	*쪼르르/MAG
쪼르륵	*쪼르륵/MAG
쫘르르	*쫘르르/MAG
쭈르르	*쭈르르/MAG
쭈르륵	*쭈르륵/MAG
찌르르	*찌르르/MAG
찌르륵	*찌르륵/MAG
찌르릉	*찌르릉/MAG
차르르	*차르르/MAG
찰그랑	*찰그랑/MAG
찰카닥	*찰카닥/MAG
창갈이	*창갈이/NNG
책씻이	*책씻이/NNG
천주학	*천주학/NNG
철면피	*철면피/NNG
철버덕	*철버덕/MAG
철버덩	*철버덩/MAG
철부지	*철부지/NNG
철커덕	*철커덕/MAG
철퍼덕	*철퍼덕/MAG
첩살이	*첩살이/NNG
첫출발	*첫출발/NNG
초다짐	*초다짐/NNG
초대면	*초대면/NNG
초절임	*초절임/NNG
총감독	*총감독/NNG
총결산	*총결산/NNG
총공격	*총공격/NNG
총궐기	*총궐기/NNG
총동원	*총동원/NNG
총망라	*총망라/NNG
총무장	*총무장/NNG
총반격	*총반격/NNG
총사직	*총사직/NNG
총사퇴	*총사퇴/NNG
총선거	*총선거/NNG
총연장	*총연장/NNG
총지휘	*총지휘/NNG
총진군	*총진군/NNG
총집결	*총집결/NNG
총집중	*총집중/NNG
총집합	*총집합/NNG
총출동	*총출동/NNG
총파업	*총파업/NNG
총합계	*총합계/NNG
추락사	*추락사/NNG
추상화	*추상화/NNG
추체험	*추체험/NNG
출세간	*출세간/NNG
출퇴근	*출퇴근/NNG
충동질	*충동질/NNG
치사랑	*치사랑/NNG
침신래	*침신래/NNG
카운트	*카운트/NNG
칸막이	*칸막이/NNG
칼부림	*칼부림/NNG
칼싸움	*칼싸움/NNG
캐스팅	*캐스팅/NNG
컨트롤	*컨트롤/NNG
케이오	*케이오/NNG
코대답	*코대답/NNG
쿠당탕	*쿠당탕/MAG
큰기침	*큰기침/NNG
큰머리	*큰머리/NNG
큰살림	*큰살림/NNG
큰소리	*큰소리/NNG
클리닝	*클리닝/NNG
클린업	*클린업/NNG
킥오프	*킥오프/NNG
타다닥	*타다닥/MAG
타이핑	*타이핑/NNG
탈놀음	*탈놀음/NNG
탈놀이	*탈놀이/NNG
탈바꿈	*탈바꿈/NNG
태무심	*태무심/NNG
태부족	*태부족/NNG
턱걸이	*턱걸이/NNG
털거덕	*털거덕/MAG
털버덕	*털버덕/MAG
털버덩	*털버덩/MAG
털커덩	*털커덩/MAG
텀블링	*텀블링/NNP
테스트	*테스트/NNG
토끼뜀	*토끼뜀/NNG
토드락	*토드락/MAG
토악질	*토악질/NNG
통사정	*통사정/NNG
통성명	*통성명/NNG
통폐합	*통폐합/NNG
트라이	*트라이/NNG
파다닥	*파다닥/MAG
파드닥	*파드닥/MAG
파드득	*파드득/MAG
파렴치	*파렴치/NNG
파르르	*파르르/MAG
판가름	*판가름/NNG
판소리	*판소리/NNG
판정승	*판정승/NNG
판정패	*판정패/NNG
팔베개	*팔베개/NNG
팔씨름	*팔씨름/NNG
패싸움	*패싸움/NNG
편미분	*편미분/NNG
편싸움	*편싸움/NNG
편입학	*편입학/NNG
평천하	*평천하/NNG
포드득	*포드득/MAG
포르르	*포르르/MAG
포르릉	*포르릉/MAG
포배기	*포배기/NNG
푸대접	*푸대접/NNG
푸드덕	*푸드덕/MAG
푸드득	*푸드득/MAG
푸르륵	*푸르륵/MAG
푸스스	*푸스스/MAG
풀가동	*풀가동/NNG
풀베기	*풀베기/NNG
풀싸움	*풀싸움/NNG
품앗이	*품앗이/NNG
품팔이	*품팔이/NNG
풋사랑	*풋사랑/NNG
풍덩실	*풍덩실/MAG
프린트	*프린트/NNG
플러스	*플러스/NNG
피사리	*피사리/NNG
하극상	*하극상/NNG
하르르	*하르르/MAG
하소연	*하소연/NNG
하안거	*하안거/NNG
하이킹	*하이킹/NNG
하정배	*하정배/NNG
한가득	*한가득/MAG
한바탕	*한바탕/MAG
한자리	*한자리/NNG
한풀이	*한풀이/NNG
해맞이	*해맞이/NNG
해수욕	*해수욕/NNG
해코지	*해코지/NNG
핵폭발	*핵폭발/NNG
허스키	*허스키/NNG
허우적	*허우적/MAG
허튼짓	*허튼짓/NNG
헤벌쭉	*헤벌쭉/MAG
헬렐레	*헬렐레/MAG
현대화	*현대화/NNG
현사당	*현사당/NNG
호르르	*호르르/MAG
혼뜨검	*혼뜨검/NNG
혼잣말	*혼잣말/NNG
홀라당	*홀라당/MAG
화다닥	*화다닥/MAG
화닥닥	*화닥닥/MAG
화드득	*화드득/MAG
화들짝	*화들짝/MAG
화르르	*화르르/MAG
화르륵	*화르륵/MAG
화풀이	*화풀이/NNG
환갑연	*환갑연/NNG
환고향	*환고향/NNG
활갯짓	*활갯짓/NNG
회까닥	*회까닥/MAG
회술레	*회술레/NNG
후다닥	*후다닥/MAG
후닥닥	*후닥닥/MAG
후두둑	*후두둑/MAG
후드득	*후드득/MAG
후루룩	*후루룩/MAG
후르르	*후르르/MAG
후르륵	*후르륵/MAG
후처리	*후처리/NNG
훌러덩	*훌러덩/MAG
휘영청	*휘영청/MAG
흐느적	*흐느적/MAG
흐르르	*흐르르/MAG
흙장난	*흙장난/NNG
흰소리	*흰소리/NNG
흰수작	*흰수작/NNG
가각	*가각/NNG
가감	*가감/NNG
가거	*가거/NNG
가격	*가격/NNG
가결	*가결/NNG
가경	*가경/NNG
가계	*가계/NNG
가공	*가공/NNG
가관	*가관/NNG
가교	*가교/NNG
가극	*가극/NNG
가금	*가금/NNG
가난	*가난/NNG
가늠	*가늠/NNG
가능	*가능/NNG
가닐	*가닐/VA
가담	*가담/NNG
가동	*가동/NNG
가득	*가득/MAG
가든	*가든/NNG
가뜩	*가뜩/MAG
가랑	*가랑/NNG
가량	*가량/NNG
가련	*가련/NNG
가령	*가령/MAG
가루	*가루/NNG
가름	*가름/NNG
가린	*가린/NNG
가마	*가마/NNG
가만	*가만/MAG
가망	*가망/NNG
가매	*가매/NNG
가맹	*가맹/NNG
가무	*가무/NNG
가미	*가미/NNG
가반	*가반/NNG
가발	*가발/NNG
가복	*가복/NNG
가봉	*가봉/NNG
가분	*가분/NNG
가불	*가불/NNG
가빈	*가빈/NNP
가산	*가산/NNG
가상	*가상/NNG
가석	*가석/NNG
가설	*가설/NNG
가소	*가소/NNG
가속	*가속/NNG
가솔	*가솔/NNG
가수	*가수/NNG
가승	*가승/NNG
가식	*가식/NNG
가압	*가압/NNG
가액	*가액/NNG
가양	*가양/NNP
가엄	*가엄/NNG
가업	*가업/NNG
가열	*가열/NNG
가용	*가용/NNG
가우	*가우/NNG
가은	*가은/NNP
가을	*가을/NNG
가입	*가입/NNG
가작	*가작/NNG
가전	*가전/NNG
가절	*가절/NNG
가정	*가정/NNG
가제	*가제/NNG
가조	*가조/NNG
가좌	*가좌/NNP
가중	*가중/NNG
가집	*가집/NNG
가징	*가징/NNG
가차	*가차/NNG
가창	*가창/NNG
가책	*가책/NNG
가체	*가체/NNG
가축	*가축/NNG
가출	*가출/NNG
가칠	*가칠/NNG
가칭	*가칭/NNG
가탁	*가탁/NNG
가토	*가토/NNP
가투	*가투/NNG
가판	*가판/NNG
가평	*가평/NNP
가피	*가피/NNG
가필	*가필/NNG
가하	*가하/VV
가학	*가학/NNG
가합	*가합/NNG
가해	*가해/NNG
가행	*가행/NNG
가형	*가형/NNG
가호	*가호/NNG
가혹	*가혹/NNG
가화	*가화/NNG
각고	*각고/NNG
각급	*각급/NNG
각담	*각담/NNG
각도	*각도/NNG
각력	*각력/NNG
각루	*각루/NNG
각목	*각목/NNG
각배	*각배/NNG
각별	*각별/NNG
각색	*각색/NNG
각설	*각설/NNG
각성	*각성/NNG
각소	*각소/NNG
각신	*각신/NNG
각양	*각양/NNG
각역	*각역/NNG
각오	*각오/NNG
각의	*각의/NNG
각인	*각인/NNG
각저	*각저/NNG
각주	*각주/NNG
각지	*각지/NNG
각축	*각축/NNG
각판	*각판/NNG
각필	*각필/NNG
각하	*각하/NNG
각혈	*각혈/NNG
간각	*간각/NNG
간간	*간간/MAG
간경	*간경/NNG
간계	*간계/NNG
간고	*간고/NNG
간과	*간과/NNG
간관	*간관/NNG
간교	*간교/NNG
간구	*간구/NNG
간기	*간기/NNG
간난	*간난/NNG
간단	*간단/NNG
간담	*간담/NNG
간도	*간도/NNP
간룡	*간룡/NNG
간만	*간만/NNG
간발	*간발/NNG
간벌	*간벌/NNG
간병	*간병/NNG
간사	*간사/NNG
간산	*간산/NNG
간색	*간색/NNG
간서	*간서/NNP
간선	*간선/NNG
간섭	*간섭/NNG
간성	*간성/NNG
간수	*간수/NNG
간식	*간식/NNG
간신	*간신/NNG
간심	*간심/NNG
간악	*간악/NNG
간언	*간언/NNG
간여	*간여/NNG
간예	*간예/NNG
간원	*간원/NNG
간음	*간음/NNG
간작	*간작/NNG
간전	*간전/NNG
간조	*간조/NNG
간주	*간주/NNG
간증	*간증/NNG
간지	*간지/NNG
간직	*간직/NNG
간질	*간질/NNG
간척	*간척/NNG
간첩	*간첩/NNG
간청	*간청/NNG
간취	*간취/NNG
간택	*간택/NNG
간통	*간통/NNG
간파	*간파/NNG
간판	*간판/NNG
간편	*간편/NNG
간평	*간평/NNG
간핵	*간핵/NNG
간행	*간행/NNG
간헐	*간헐/NNG
간호	*간호/NNG
간혼	*간혼/NNG
간흉	*간흉/NNG
갈갈	*갈갈/MAG
갈구	*갈구/NNG
갈근	*갈근/NNG
갈급	*갈급/NNG
갈도	*갈도/NNP
갈등	*갈등/NNG
갈망	*갈망/NNG
갈변	*갈변/NNG
갈신	*갈신/NNG
갈앙	*갈앙/NNG
갈애	*갈애/NNG
갈음	*갈음/NNG
갈채	*갈채/NNG
갈취	*갈취/NNG
갈파	*갈파/NNG
감가	*감가/NNG
감각	*감각/NNG
감감	*감감/MAG
감개	*감개/NNG
감격	*감격/NNG
감경	*감경/NNG
감관	*감관/NNG
감광	*감광/NNG
감군	*감군/NNG
감금	*감금/NNG
감납	*감납/NNG
감내	*감내/NNG
감농	*감농/NNG
감단	*감단/NNG
감당	*감당/NNG
감도	*감도/NNG
감독	*감독/NNG
감동	*감동/NNG
감득	*감득/NNG
감람	*감람/NNG
감량	*감량/NNG
감리	*감리/NNG
감마	*감마/NNG
감면	*감면/NNG
감명	*감명/NNG
감모	*감모/NNG
감미	*감미/NNG
감발	*감발/NNG
감방	*감방/NNG
감별	*감별/NNG
감보	*감보/NNG
감복	*감복/NNG
감봉	*감봉/NNG
감사	*감사/NNG
감산	*감산/NNG
감상	*감상/NNG
감색	*감색/NNG
감선	*감선/NNG
감성	*감성/NNG
감세	*감세/NNG
감소	*감소/NNG
감속	*감속/NNG
감쇄	*감쇄/NNG
감쇠	*감쇠/NNG
감수	*감수/NNG
감시	*감시/NNG
감식	*감식/NNG
감실	*감실/NNG
감심	*감심/NNG
감안	*감안/NNG
감압	*감압/NNG
감액	*감액/NNG
감역	*감역/NNG
감염	*감염/NNG
감원	*감원/NNG
감위	*감위/NNG
감읍	*감읍/NNG
감응	*감응/NNG
감자	*감자/NNG
감장	*감장/NNG
감전	*감전/NNG
감점	*감점/NNG
감정	*감정/NNG
감제	*감제/NNG
감주	*감주/NNG
감지	*감지/NNG
감차	*감차/NNG
감찰	*감찰/NNG
감천	*감천/NNG
감청	*감청/NNG
감촉	*감촉/NNG
감축	*감축/NNG
감탄	*감탄/NNG
감통	*감통/NNG
감퇴	*감퇴/NNG
감투	*감투/NNG
감편	*감편/NNG
감표	*감표/NNG
감하	*감하/VV
감합	*감합/NNG
감행	*감행/NNG
감형	*감형/NNG
감호	*감호/NNG
감화	*감화/NNG
감회	*감회/NNG
갑신	*갑신/NNG
강가	*강가/NNG
강간	*강간/NNG
강개	*강개/NNG
강겁	*강겁/NNG
강격	*강격/NNG
강경	*강경/NNG
강계	*강계/NNP
강공	*강공/NNG
강관	*강관/NNG
강구	*강구/NNG
강권	*강권/NNG
강녕	*강녕/NNG
강단	*강단/NNG
강담	*강담/NNG
강대	*강대/NNG
강독	*강독/NNG
강동	*강동/NNP
강등	*강등/NNG
강령	*강령/NNG
강론	*강론/NNG
강림	*강림/NNG
강매	*강매/NNG
강박	*강박/NNG
강반	*강반/NNG
강변	*강변/NNG
강보	*강보/NNG
강복	*강복/NNG
강상	*강상/NNG
강서	*강서/NNP
강설	*강설/NNG
강성	*강성/NNG
강세	*강세/NNG
강송	*강송/NNG
강쇠	*강쇠/NNG
강수	*강수/NNG
강술	*강술/NNG
강슛	*강슛/NNG
강습	*강습/NNG
강식	*강식/NNG
강신	*강신/NNG
강압	*강압/NNG
강연	*강연/NNG
강열	*강열/NNG
강왕	*강왕/NNP
강요	*강요/NNG
강우	*강우/NNG
강음	*강음/NNP
강의	*강의/NNG
강자	*강자/NNG
강장	*강장/NNG
강점	*강점/NNG
강정	*강정/NNG
강제	*강제/NNG
강조	*강조/NNG
강종	*강종/NNG
강주	*강주/NNG
강중	*강중/NNG
강지	*강지/NNP
강직	*강직/NNG
강짜	*강짜/NNG
강청	*강청/NNG
강충	*강충/NNP
강타	*강타/NNG
강탈	*강탈/NNG
강판	*강판/NNG
강퍅	*강퍅/NNG
강평	*강평/NNG
강포	*강포/NNG
강학	*강학/NNG
강항	*강항/NNP
강해	*강해/NNG
강행	*강행/NNG
강화	*강화/NNG
같이	*같이/MAG
개각	*개각/NNG
개간	*개간/NNG
개강	*개강/NNG
개결	*개결/NNG
개관	*개관/NNG
개괄	*개괄/NNG
개광	*개광/NNG
개구	*개구/NNG
개굴	*개굴/NNG
개근	*개근/NNG
개독	*개독/NNG
개략	*개략/NNG
개량	*개량/NNG
개론	*개론/NNG
개막	*개막/NNG
개명	*개명/NNG
개문	*개문/NNG
개발	*개발/NNG
개방	*개방/NNG
개벽	*개벽/NNG
개변	*개변/NNG
개복	*개복/NNG
개봉	*개봉/NNG
개비	*개비/NNG
개사	*개사/NNG
개산	*개산/NNG
개서	*개서/NNG
개선	*개선/NNG
개설	*개설/NNG
개수	*개수/NNG
개시	*개시/NNG
개식	*개식/NNG
개신	*개신/NNG
개심	*개심/NNG
개악	*개악/NNG
개안	*개안/NNG
개업	*개업/NNG
개연	*개연/NNG
개원	*개원/NNG
개유	*개유/NNG
개인	*개인/NNG
개입	*개입/NNG
개자	*개자/NNG
개작	*개작/NNG
개장	*개장/NNG
개재	*개재/NNG
개전	*개전/NNG
개점	*개점/NNG
개정	*개정/NNG
개제	*개제/NNG
개종	*개종/NNG
개좌	*개좌/NNG
개진	*개진/NNG
개차	*개차/NNG
개찰	*개찰/NNG
개창	*개창/NNG
개척	*개척/NNG
개천	*개천/NNG
개청	*개청/NNG
개체	*개체/NNG
개최	*개최/NNG
개축	*개축/NNG
개칠	*개칠/NNG
개칭	*개칭/NNG
개탄	*개탄/NNG
개토	*개토/NNG
개통	*개통/NNG
개판	*개판/NNG
개편	*개편/NNG
개평	*개평/NNG
개폐	*개폐/NNG
개표	*개표/NNG
개학	*개학/NNG
개헌	*개헌/NNG
개혁	*개혁/NNG
개호	*개호/NNG
개혼	*개혼/NNG
개화	*개화/NNG
개황	*개황/NNG
개회	*개회/NNG
객고	*객고/NNG
객담	*객담/NNG
객사	*객사/NNG
객주	*객주/NNG
객토	*객토/NNG
객혈	*객혈/NNG
갱생	*갱생/NNG
갱신	*갱신/NNG
갱유	*갱유/NNG
갸웃	*갸웃/MAG
갹출	*갹출/NNG
거간	*거간/NNG
거관	*거관/NNG
거괴	*거괴/NNG
거국	*거국/NNG
거근	*거근/NNG
거금	*거금/NNG
거기	*거기/NP
거냉	*거냉/NNG
거담	*거담/NNG
거대	*거대/NNG
거동	*거동/NNG
거둥	*거둥/NNG
거듭	*거듭/MAG
거래	*거래/NNG
거례	*거례/NNG
거론	*거론/NNG
거류	*거류/NNG
거름	*거름/NNG
거만	*거만/NNG
거명	*거명/NNG
거목	*거목/NNG
거물	*거물/NNG
거병	*거병/NNG
거부	*거부/NNG
거북	*거북/NNG
거사	*거사/NNG
거산	*거산/NNP
거상	*거상/NNG
거성	*거성/NNG
거소	*거소/NNG
거수	*거수/NNG
거시	*거시/NNG
거실	*거실/NNG
거양	*거양/NNG
거역	*거역/NNG
거위	*거위/NNG
거재	*거재/NNG
거절	*거절/NNG
거조	*거조/NNG
거주	*거주/NNG
거증	*거증/NNG
거처	*거처/NNG
거총	*거총/NNG
거출	*거출/NNG
거칠	*거칠/VA
거칫	*거칫/MAG
거탈	*거탈/NNG
거포	*거포/NNG
거푸	*거푸/MAG
거풍	*거풍/NNG
거피	*거피/NNG
거행	*거행/NNG
거화	*거화/NNG
걱정	*걱정/NNG
건각	*건각/NNG
건강	*건강/NNG
건국	*건국/NNG
건군	*건군/NNG
건기	*건기/NNG
건담	*건담/NNG
건덕	*건덕/NNP
건들	*건들/VV
건류	*건류/NNG
건립	*건립/NNG
건망	*건망/NNG
건면	*건면/NNG
건배	*건배/NNG
건사	*건사/NNG
건설	*건설/NNG
건수	*건수/NNG
건식	*건식/NNG
건아	*건아/NNG
건원	*건원/NNP
건의	*건의/NNG
건재	*건재/NNG
건전	*건전/NNG
건조	*건조/NNG
건즐	*건즐/NNG
건축	*건축/NNG
건투	*건투/NNG
건학	*건학/NNG
걸구	*걸구/NNG
걸군	*걸군/NNG
걸대	*걸대/NNG
걸립	*걸립/NNG
걸식	*걸식/NNG
걸신	*걸신/NNG
걸출	*걸출/NNG
검거	*검거/NNG
검단	*검단/NNP
검도	*검도/NNG
검문	*검문/NNG
검사	*검사/NNG
검산	*검산/NNG
검색	*검색/NNG
검소	*검소/NNG
검속	*검속/NNG
검수	*검수/NNG
검시	*검시/NNG
검안	*검안/NNG
검약	*검약/NNG
검역	*검역/NNG
검열	*검열/NNG
검인	*검인/NNG
검정	*검정/NNG
검증	*검증/NNG
검지	*검지/NNG
검진	*검진/NNG
검찰	*검찰/NNG
검출	*검출/NNG
검침	*검침/NNG
검토	*검토/NNG
검표	*검표/NNG
겁간	*겁간/NNG
겁나	*겁나/VV
겁탈	*겁탈/NNG
겅정	*겅정/MAG
겅중	*겅중/MAG
겉칠	*겉칠/NNG
게방	*게방/NNG
게시	*게시/NNG
게양	*게양/NNG
게재	*게재/NNG
게정	*게정/NNG
게첩	*게첩/NNG
겨냥	*겨냥/NNG
겨룸	*겨룸/NNG
격감	*격감/NNG
격년	*격년/NNG
격노	*격노/NNG
격돌	*격돌/NNG
격동	*격동/NNG
격려	*격려/NNG
격론	*격론/NNG
격리	*격리/NNG
격멸	*격멸/NNG
격물	*격물/NNG
격발	*격발/NNG
격변	*격변/NNG
격분	*격분/NNG
격상	*격상/NNG
격세	*격세/NNG
격앙	*격앙/NNG
격양	*격양/NNG
격월	*격월/NNG
격일	*격일/NNG
격자	*격자/NNG
격장	*격장/NNG
격전	*격전/NNG
격절	*격절/NNG
격조	*격조/NNG
격주	*격주/NNG
격증	*격증/NNG
격찬	*격찬/NNG
격추	*격추/NNG
격침	*격침/NNG
격퇴	*격퇴/NNG
격투	*격투/NNG
격파	*격파/NNG
격호	*격호/NNP
격화	*격화/NNG
견명	*견명/NNG
견모	*견모/NNG
견문	*견문/NNG
견성	*견성/NNG
견인	*견인/NNG
견적	*견적/NNG
견제	*견제/NNG
견지	*견지/NNG
견책	*견책/NNG
견치	*견치/NNG
견학	*견학/NNG
견해	*견해/NNG
결각	*결각/NNG
결강	*결강/NNG
결격	*결격/NNG
결계	*결계/NNG
결곤	*결곤/NNG
결과	*결과/NNG
결교	*결교/NNG
결구	*결구/NNG
결근	*결근/NNG
결기	*결기/NNG
결납	*결납/NNG
결단	*결단/NNG
결당	*결당/NNG
결락	*결락/NNG
결렬	*결렬/NNG
결렴	*결렴/NNG
결례	*결례/NNG
결론	*결론/NNG
결박	*결박/NNG
결발	*결발/NNG
결백	*결백/NNG
결번	*결번/NNG
결벽	*결벽/NNG
결별	*결별/NNG
결부	*결부/NNG
결빙	*결빙/NNG
결사	*결사/NNG
결산	*결산/NNG
결석	*결석/NNG
결선	*결선/NNG
결성	*결성/NNG
결속	*결속/NNG
결승	*결승/NNG
결식	*결식/NNG
결신	*결신/NNG
결실	*결실/NNG
결심	*결심/NNG
결여	*결여/NNG
결연	*결연/NNG
결원	*결원/NNG
결의	*결의/NNG
결장	*결장/NNG
결재	*결재/NNG
결전	*결전/NNG
결절	*결절/NNG
결정	*결정/NNG
결제	*결제/NNG
결진	*결진/NNG
결집	*결집/NNG
결착	*결착/NNG
결처	*결처/NNG
결체	*결체/NNG
결탁	*결탁/NNG
결투	*결투/NNG
결판	*결판/NNG
결핍	*결핍/NNG
결하	*결하/VV
결함	*결함/NNG
결합	*결합/NNG
결항	*결항/NNG
결행	*결행/NNG
결호	*결호/NNG
결혼	*결혼/NNG
겸대	*겸대/NNG
겸무	*겸무/NNG
겸병	*겸병/NNG
겸비	*겸비/NNG
겸사	*겸사/NNG
겸상	*겸상/NNG
겸손	*겸손/NNG
겸애	*겸애/NNG
겸양	*겸양/NNG
겸업	*겸업/NNG
겸영	*겸영/NNG
겸용	*겸용/NNG
겸임	*겸임/NNG
겸전	*겸전/NNG
겸직	*겸직/NNG
겸하	*겸하/VV
겸행	*겸행/NNG
겸허	*겸허/NNG
겹겹	*겹겹/NNG
경각	*경각/NNG
경간	*경간/NNG
경감	*경감/NNG
경개	*경개/NNG
경건	*경건/NNG
경겁	*경겁/NNG
경결	*경결/NNG
경경	*경경/NNG
경계	*경계/NNG
경고	*경고/NNG
경과	*경과/NNG
경구	*경구/NNG
경국	*경국/NNG
경기	*경기/NNG
경난	*경난/NNG
경농	*경농/NNG
경단	*경단/NNG
경대	*경대/NNG
경도	*경도/NNG
경동	*경동/NNP
경락	*경락/NNG
경략	*경략/NNG
경력	*경력/NNG
경련	*경련/NNG
경례	*경례/NNG
경로	*경로/NNG
경륜	*경륜/NNG
경리	*경리/NNG
경마	*경마/NNG
경만	*경만/NNP
경망	*경망/NNG
경매	*경매/NNG
경면	*경면/NNG
경멸	*경멸/NNG
경모	*경모/NNG
경민	*경민/NNP
경박	*경박/NNG
경배	*경배/NNG
경보	*경보/NNG
경복	*경복/NNG
경봉	*경봉/NNP
경부	*경부/NNG
경비	*경비/NNG
경사	*경사/NNG
경산	*경산/NNP
경상	*경상/NNG
경색	*경색/NNG
경서	*경서/NNG
경선	*경선/NNG
경섭	*경섭/NNP
경성	*경성/NNP
경세	*경세/NNG
경솔	*경솔/NNG
경순	*경순/NNP
경승	*경승/NNG
경시	*경시/NNG
경신	*경신/NNG
경심	*경심/NNP
경아	*경아/NNP
경악	*경악/NNG
경앙	*경앙/NNG
경애	*경애/NNG
경업	*경업/NNG
경연	*경연/NNG
경염	*경염/NNG
경영	*경영/NNG
경오	*경오/NNG
경외	*경외/NNG
경위	*경위/NNG
경유	*경유/NNG
경음	*경음/NNG
경의	*경의/NNG
경이	*경이/NNG
경인	*경인/NNP
경작	*경작/NNG
경장	*경장/NNG
경쟁	*경쟁/NNG
경적	*경적/NNG
경전	*경전/NNG
경절	*경절/NNP
경정	*경정/NNG
경제	*경제/NNG
경조	*경조/NNG
경종	*경종/NNG
경중	*경중/NNG
경지	*경지/NNG
경직	*경직/NNG
경진	*경진/NNG
경질	*경질/NNG
경찰	*경찰/NNG
경천	*경천/NNG
경첩	*경첩/NNG
경청	*경청/NNG
경추	*경추/NNG
경축	*경축/NNG
경칭	*경칭/NNG
경탄	*경탄/NNG
경패	*경패/NNG
경편	*경편/NNG
경폐	*경폐/NNG
경포	*경포/NNP
경풍	*경풍/NNG
경하	*경하/NNG
경합	*경합/NNG
경험	*경험/NNG
경호	*경호/NNG
경화	*경화/NNG
경환	*경환/NNP
경황	*경황/NNG
경희	*경희/NNP
계가	*계가/NNG
계간	*계간/NNG
계고	*계고/NNG
계관	*계관/NNG
계교	*계교/NNG
계구	*계구/NNG
계귀	*계귀/NNG
계금	*계금/NNG
계기	*계기/NNG
계도	*계도/NNG
계량	*계량/NNG
계례	*계례/NNG
계루	*계루/NNG
계류	*계류/NNG
계면	*계면/NNG
계명	*계명/NNG
계몽	*계몽/NNG
계문	*계문/NNG
계박	*계박/NNG
계발	*계발/NNG
계방	*계방/NNG
계배	*계배/NNG
계백	*계백/NNP
계빈	*계빈/NNG
계사	*계사/NNG
계산	*계산/NNG
계상	*계상/NNG
계서	*계서/NNG
계선	*계선/NNG
계세	*계세/NNG
계승	*계승/NNG
계심	*계심/NNG
계약	*계약/NNG
계양	*계양/NNG
계영	*계영/NNG
계월	*계월/NNG
계위	*계위/NNG
계율	*계율/NNG
계장	*계장/NNG
계쟁	*계쟁/NNG
계적	*계적/NNG
계전	*계전/NNG
계절	*계절/NNG
계정	*계정/NNG
계제	*계제/NNG
계주	*계주/NNG
계차	*계차/NNG
계책	*계책/NNG
계청	*계청/NNG
계촌	*계촌/NNG
계측	*계측/NNG
계칩	*계칩/NNG
계통	*계통/NNG
계투	*계투/NNG
계품	*계품/NNG
계하	*계하/VV
계행	*계행/NNG
계호	*계호/NNG
계획	*계획/NNG
고가	*고가/NNG
고간	*고간/NNG
고갈	*고갈/NNG
고개	*고개/NNG
고거	*고거/NP
고검	*고검/NNG
고견	*고견/NNG
고결	*고결/NNG
고경	*고경/NNG
고고	*고고/NNG
고공	*고공/NNG
고과	*고과/NNG
고관	*고관/NNG
고광	*고광/NNG
고교	*고교/NNG
고구	*고구/NNG
고궁	*고궁/NNG
고금	*고금/NNG
고급	*고급/NNG
고기	*고기/NNG
고농	*고농/NNG
고뇌	*고뇌/NNG
고담	*고담/NNG
고답	*고답/NNG
고대	*고대/NNG
고덕	*고덕/NNG
고데	*고데/NNG
고도	*고도/NNG
고독	*고독/NNG
고등	*고등/NNG
고락	*고락/NNG
고량	*고량/NNG
고로	*고로/MAG
고리	*고리/NNG
고립	*고립/NNG
고릿	*고릿/MAG
고명	*고명/NNG
고목	*고목/NNG
고묘	*고묘/NNG
고무	*고무/NNG
고문	*고문/NNG
고물	*고물/NNG
고민	*고민/NNG
고발	*고발/NNG
고방	*고방/NNG
고배	*고배/NNG
고백	*고백/NNG
고변	*고변/NNG
고별	*고별/NNG
고보	*고보/NNG
고복	*고복/NNG
고봉	*고봉/NNG
고부	*고부/NNG
고분	*고분/NNG
고불	*고불/NNG
고비	*고비/NNG
고사	*고사/NNG
고상	*고상/NNG
고생	*고생/NNG
고성	*고성/NNG
고소	*고소/NNG
고수	*고수/NNG
고습	*고습/NNG
고시	*고시/NNG
고신	*고신/NNG
고실	*고실/NNG
고심	*고심/NNG
고안	*고안/NNG
고약	*고약/NNG
고오	*고오/NNP
고옥	*고옥/NNG
고요	*고요/NNG
고용	*고용/NNG
고원	*고원/NNG
고위	*고위/NNG
고유	*고유/NNG
고율	*고율/NNG
고은	*고은/NNP
고의	*고의/NNG
고일	*고일/NNG
고입	*고입/NNG
고장	*고장/NNG
고적	*고적/NNG
고전	*고전/NNG
고절	*고절/NNG
고정	*고정/NNG
고제	*고제/NNG
고조	*고조/NNG
고졸	*고졸/NNG
고종	*고종/NNP
고주	*고주/NNG
고증	*고증/NNG
고지	*고지/NNG
고집	*고집/NNG
고착	*고착/NNG
고찰	*고찰/NNG
고창	*고창/NNP
고천	*고천/NNG
고체	*고체/NNG
고추	*고추/NNG
고축	*고축/NNG
고취	*고취/NNG
고퇴	*고퇴/NNG
고투	*고투/NNG
고학	*고학/NNG
고해	*고해/NNG
고행	*고행/NNG
고향	*고향/NNG
고현	*고현/NNG
고혈	*고혈/NNG
고호	*고호/NNP
고혹	*고혹/NNG
고환	*고환/NNG
곡류	*곡류/NNG
곡비	*곡비/NNG
곡읍	*곡읍/NNG
곡절	*곡절/NNG
곡종	*곡종/NNG
곡천	*곡천/NNP
곡필	*곡필/NNG
곡해	*곡해/NNG
곤궁	*곤궁/NNG
곤난	*곤난/NNG
곤란	*곤란/NNG
곤로	*곤로/NNG
곤복	*곤복/NNG
곤색	*곤색/NNG
곤작	*곤작/NNG
곤지	*곤지/NNG
곤포	*곤포/NNG
곤혹	*곤혹/NNG
골막	*골막/NNG
골몰	*골몰/NNG
골패	*골패/NNG
곱상	*곱상/NNG
곱셈	*곱셈/NNG
곱실	*곱실/NNG
곱절	*곱절/NNG
공간	*공간/NNG
공갈	*공갈/NNG
공감	*공감/NNG
공개	*공개/NNG
공격	*공격/NNG
공경	*공경/NNG
공고	*공고/NNG
공공	*공공/NNG
공관	*공관/NNG
공구	*공구/NNG
공궤	*공궤/NNG
공극	*공극/NNG
공급	*공급/NNG
공기	*공기/NNG
공납	*공납/NNG
공노	*공노/NNG
공대	*공대/NNG
공도	*공도/NNG
공동	*공동/NNG
공람	*공람/NNG
공략	*공략/NNG
공렴	*공렴/NNP
공로	*공로/NNG
공론	*공론/NNG
공립	*공립/NNG
공매	*공매/NNG
공멸	*공멸/NNG
공명	*공명/NNG
공모	*공모/NNG
공무	*공무/NNG
공박	*공박/NNG
공방	*공방/NNG
공벌	*공벌/NNG
공범	*공범/NNG
공부	*공부/NNG
공분	*공분/NNG
공비	*공비/NNG
공사	*공사/NNG
공상	*공상/NNG
공생	*공생/NNG
공서	*공서/NNG
공석	*공석/NNG
공선	*공선/NNG
공설	*공설/NNG
공소	*공소/NNG
공수	*공수/NNG
공술	*공술/NNG
공습	*공습/NNG
공시	*공시/NNG
공식	*공식/NNG
공신	*공신/NNG
공약	*공약/NNG
공양	*공양/NNG
공어	*공어/NNG
공언	*공언/NNG
공여	*공여/NNG
공역	*공역/NNG
공연	*공연/NNG
공영	*공영/NNG
공용	*공용/NNG
공위	*공위/NNG
공유	*공유/NNG
공의	*공의/NNG
공인	*공인/NNG
공작	*공작/NNG
공장	*공장/NNG
공재	*공재/NNP
공저	*공저/NNG
공적	*공적/NNG
공전	*공전/NNG
공정	*공정/NNG
공제	*공제/NNG
공조	*공조/NNG
공존	*공존/NNG
공증	*공증/NNG
공지	*공지/NNG
공직	*공직/NNG
공찰	*공찰/NNG
공참	*공참/NNG
공창	*공창/NNG
공채	*공채/NNG
공천	*공천/NNG
공축	*공축/NNG
공출	*공출/NNG
공취	*공취/NNG
공탁	*공탁/NNG
공통	*공통/NNG
공판	*공판/NNG
공편	*공편/NNG
공평	*공평/NNG
공포	*공포/NNG
공표	*공표/NNG
공학	*공학/NNG
공한	*공한/NNG
공헌	*공헌/NNG
공화	*공화/NNG
과거	*과거/NNG
과금	*과금/NNG
과년	*과년/NNG
과다	*과다/NNG
과단	*과단/NNG
과당	*과당/NNG
과대	*과대/NNG
과도	*과도/NNG
과람	*과람/NNG
과랭	*과랭/NNG
과량	*과량/NNG
과로	*과로/NNG
과만	*과만/NNG
과묵	*과묵/NNG
과문	*과문/NNG
과민	*과민/NNG
과밀	*과밀/NNG
과방	*과방/NNG
과부	*과부/NNG
과불	*과불/NNG
과세	*과세/NNG
과소	*과소/NNG
과속	*과속/NNG
과수	*과수/NNG
과숙	*과숙/NNG
과시	*과시/NNG
과식	*과식/NNG
과신	*과신/NNG
과언	*과언/NNG
과열	*과열/NNG
과욕	*과욕/NNG
과용	*과용/NNG
과음	*과음/NNG
과인	*과인/NP
과일	*과일/NNG
과잉	*과잉/NNG
과작	*과작/NNG
과장	*과장/NNG
과적	*과적/NNG
과점	*과점/NNG
과제	*과제/NNG
과중	*과중/NNG
과찬	*과찬/NNG
과책	*과책/NNG
과형	*과형/NNG
관개	*관개/NNG
관계	*관계/NNG
관곡	*관곡/NNG
관광	*관광/NNG
관구	*관구/NNG
관극	*관극/NNG
관급	*관급/NNG
관념	*관념/NNG
관대	*관대/NNG
관독	*관독/NNG
관등	*관등/NNG
관람	*관람/NNG
관련	*관련/NNG
관례	*관례/NNG
관류	*관류/NNG
관리	*관리/NNG
관망	*관망/NNG
관면	*관면/NNG
관문	*관문/NNG
관방	*관방/NNG
관병	*관병/NNG
관복	*관복/NNG
관봉	*관봉/NNG
관사	*관사/NNG
관상	*관상/NNG
관서	*관서/NNG
관선	*관선/NNG
관섭	*관섭/NNP
관수	*관수/NNG
관심	*관심/NNG
관악	*관악/NNP
관여	*관여/NNG
관영	*관영/NNG
관용	*관용/NNG
관유	*관유/NNG
관인	*관인/NNG
관장	*관장/NNG
관재	*관재/NNG
관전	*관전/NNG
관절	*관절/NNG
관정	*관정/NNG
관제	*관제/NNG
관조	*관조/NNG
관중	*관중/NNG
관찬	*관찬/NNG
관찰	*관찰/NNG
관창	*관창/NNG
관천	*관천/NNP
관철	*관철/NNG
관청	*관청/NNG
관측	*관측/NNG
관통	*관통/NNG
관풍	*관풍/NNG
관할	*관할/NNG
관행	*관행/NNG
관허	*관허/NNG
괄목	*괄목/NNG
괄발	*괄발/NNG
괄시	*괄시/NNG
광고	*광고/NNG
광교	*광교/NNP
광구	*광구/NNG
광대	*광대/NNG
광도	*광도/NNG
광란	*광란/NNG
광량	*광량/NNG
광림	*광림/NNP
광망	*광망/NNG
광명	*광명/NNG
광문	*광문/NNG
광박	*광박/NNG
광복	*광복/NNG
광분	*광분/NNG
광사	*광사/NNG
광선	*광선/NNG
광신	*광신/NNG
광양	*광양/NNP
광역	*광역/NNG
광원	*광원/NNG
광음	*광음/NNG
광자	*광자/NNG
광작	*광작/NNG
광장	*광장/NNG
광점	*광점/NNG
광정	*광정/NNG
광조	*광조/NNG
광채	*광채/NNG
광파	*광파/NNG
광포	*광포/NNG
광폭	*광폭/NNG
광학	*광학/NNG
광화	*광화/NNG
광휘	*광휘/NNG
광희	*광희/NNG
괘념	*괘념/NNG
괘서	*괘서/NNG
괘심	*괘심/NNG
괘의	*괘의/NNG
괴기	*괴기/NNG
괴리	*괴리/NNG
괴멸	*괴멸/NNG
괴벽	*괴벽/NNG
괴변	*괴변/NNG
괴사	*괴사/NNG
괴산	*괴산/NNP
괴상	*괴상/NNG
괴수	*괴수/NNG
괴안	*괴안/NNG
괴오	*괴오/VV
괴인	*괴인/NNG
괴천	*괴천/NNP
굉음	*굉음/NNG
교감	*교감/NNG
교계	*교계/NNG
교과	*교과/NNG
교관	*교관/NNG
교구	*교구/NNG
교권	*교권/NNG
교대	*교대/NNG
교도	*교도/NNG
교란	*교란/NNG
교려	*교려/NNG
교련	*교련/NNG
교령	*교령/NNG
교로	*교로/NNG
교류	*교류/NNG
교만	*교만/NNG
교무	*교무/NNG
교미	*교미/NNG
교민	*교민/NNG
교반	*교반/NNG
교배	*교배/NNG
교복	*교복/NNG
교부	*교부/NNG
교빙	*교빙/NNG
교사	*교사/NNG
교살	*교살/NNG
교상	*교상/NNG
교서	*교서/NNG
교설	*교설/NNG
교섭	*교섭/NNG
교세	*교세/NNG
교수	*교수/NNG
교습	*교습/NNG
교신	*교신/NNG
교양	*교양/NNG
교언	*교언/NNG
교역	*교역/NNG
교열	*교열/NNG
교우	*교우/NNG
교위	*교위/NNG
교유	*교유/NNG
교육	*교육/NNG
교인	*교인/NNG
교자	*교자/NNG
교잡	*교잡/NNG
교전	*교전/NNG
교점	*교점/NNG
교접	*교접/NNG
교정	*교정/NNG
교제	*교제/NNG
교좌	*교좌/NNG
교주	*교주/NNG
교지	*교지/NNG
교직	*교직/NNG
교질	*교질/NNG
교차	*교차/NNG
교착	*교착/NNG
교체	*교체/NNG
교칙	*교칙/NNG
교탁	*교탁/NNG
교태	*교태/NNG
교토	*교토/NNP
교통	*교통/NNG
교포	*교포/NNG
교학	*교학/NNG
교합	*교합/NNG
교호	*교호/NNG
교혼	*교혼/NNG
교화	*교화/NNG
교환	*교환/NNG
교회	*교회/NNG
교훈	*교훈/NNG
구가	*구가/NNG
구간	*구간/NNG
구갈	*구갈/NNG
구개	*구개/NNG
구거	*구거/NNG
구걸	*구걸/NNG
구경	*구경/NNG
구고	*구고/NNG
구곡	*구곡/NNP
구관	*구관/NNG
구교	*구교/NNG
구국	*구국/NNG
구근	*구근/NNG
구금	*구금/NNG
구급	*구급/NNG
구내	*구내/NNG
구니	*구니/NNG
구단	*구단/NNG
구달	*구달/NNP
구덕	*구덕/NNG
구도	*구도/NNG
구독	*구독/NNG
구동	*구동/NNG
구두	*구두/NNG
구득	*구득/NNG
구령	*구령/NNG
구례	*구례/NNP
구로	*구로/NNP
구론	*구론/NNG
구류	*구류/NNG
구매	*구매/NNG
구면	*구면/NNG
구명	*구명/NNG
구목	*구목/NNG
구몰	*구몰/NNG
구문	*구문/NNG
구물	*구물/NNG
구미	*구미/NNP
구민	*구민/NNG
구박	*구박/NNG
구배	*구배/NNG
구변	*구변/NNG
구별	*구별/NNG
구보	*구보/NNG
구비	*구비/NNG
구산	*구산/NNG
구살	*구살/NNG
구상	*구상/NNG
구색	*구색/NNG
구성	*구성/NNG
구세	*구세/NNG
구속	*구속/NNG
구송	*구송/NNG
구순	*구순/NNG
구술	*구술/NNG
구식	*구식/NNG
구신	*구신/NNG
구실	*구실/NNG
구심	*구심/NNG
구애	*구애/NNG
구약	*구약/NNP
구역	*구역/NNG
구연	*구연/NNG
구완	*구완/NNG
구우	*구우/NNG
구원	*구원/NNG
구위	*구위/NNG
구유	*구유/NNG
구음	*구음/NNG
구인	*구인/NNG
구입	*구입/NNG
구재	*구재/NNG
구적	*구적/NNG
구전	*구전/NNG
구제	*구제/NNG
구조	*구조/NNG
구족	*구족/NNP
구존	*구존/NNG
구종	*구종/NNG
구주	*구주/NNP
구증	*구증/NNG
구직	*구직/NNG
구차	*구차/NNG
구처	*구처/NNG
구청	*구청/NNG
구초	*구초/NNG
구축	*구축/NNG
구출	*구출/NNG
구충	*구충/NNG
구취	*구취/NNG
구치	*구치/NNG
구타	*구타/NNG
구토	*구토/NNG
구투	*구투/NNG
구포	*구포/NNP
구품	*구품/NNG
구현	*구현/NNG
구형	*구형/NNG
구호	*구호/NNG
구혼	*구혼/NNG
구화	*구화/NNG
구황	*구황/NNG
구회	*구회/NNG
구획	*구획/NNG
구휼	*구휼/NNG
국궁	*국궁/NNG
국금	*국금/NNG
국문	*국문/NNG
국보	*국보/NNG
국선	*국선/NNG
국수	*국수/NNG
국신	*국신/NNG
국양	*국양/NNP
국역	*국역/NNG
국영	*국영/NNG
국장	*국장/NNG
국정	*국정/NNG
국척	*국척/NNG
국축	*국축/NNG
국한	*국한/NNG
군거	*군거/NNG
군검	*군검/NNG
군기	*군기/NNG
군납	*군납/NNG
군림	*군림/NNG
군말	*군말/NNG
군무	*군무/NNG
군비	*군비/NNG
군생	*군생/NNG
군서	*군서/NNG
군속	*군속/NNG
군졸	*군졸/NNG
군집	*군집/NNG
군축	*군축/NNG
군호	*군호/NNG
굴곡	*굴곡/NNG
굴기	*굴기/NNG
굴복	*굴복/NNG
굴신	*굴신/NNG
굴절	*굴절/NNG
굴종	*굴종/NNG
굴지	*굴지/NNG
굴착	*굴착/NNG
굴혈	*굴혈/NNG
굼닐	*굼닐/VA
굽신	*굽신/MAG
굽실	*굽실/MAG
궁가	*궁가/NNG
궁고	*궁고/NNG
궁구	*궁구/NNG
궁굴	*궁굴/VA
궁극	*궁극/NNG
궁급	*궁급/NNG
궁량	*궁량/NNG
궁리	*궁리/NNG
궁사	*궁사/NNG
궁색	*궁색/NNG
궁설	*궁설/NNG
궁액	*궁액/NNG
궁주	*궁주/NNG
궁핍	*궁핍/NNG
궁행	*궁행/NNG
권고	*권고/NNG
권근	*권근/NNP
권농	*권농/NNG
권당	*권당/NNG
권도	*권도/NNG
권력	*권력/NNG
권련	*권련/NNG
권면	*권면/NNG
권선	*권선/NNG
권속	*권속/NNG
권수	*권수/NNG
권업	*권업/NNG
권유	*권유/NNG
권장	*권장/NNG
권항	*권항/NNG
권화	*권화/NNG
궐기	*궐기/NNG
궐석	*궐석/NNG
궐위	*궐위/NNG
궐자	*궐자/NNG
궤멸	*궤멸/NNG
궤배	*궤배/NNG
귀결	*귀결/NNG
귀경	*귀경/NNG
귀관	*귀관/NNG
귀교	*귀교/NNG
귀국	*귀국/NNG
귀납	*귀납/NNG
귀농	*귀농/NNG
귀대	*귀대/NNG
귀띔	*귀띔/NNG
귀래	*귀래/NNG
귀로	*귀로/NNG
귀명	*귀명/NNG
귀부	*귀부/NNG
귀선	*귀선/NNG
귀성	*귀성/NNG
귀순	*귀순/NNG
귀심	*귀심/NNG
귀애	*귀애/NNG
귀양	*귀양/NNG
귀와	*귀와/NNG
귀의	*귀의/NNG
귀일	*귀일/NNG
귀임	*귀임/NNG
귀장	*귀장/NNG
귀적	*귀적/NNG
귀전	*귀전/NNG
귀정	*귀정/NNG
귀조	*귀조/NNG
귀착	*귀착/NNG
귀책	*귀책/NNG
귀천	*귀천/NNG
귀청	*귀청/NNG
귀항	*귀항/NNG
귀향	*귀향/NNG
귀화	*귀화/NNG
귀환	*귀환/NNG
귀휴	*귀휴/NNG
규명	*규명/NNG
규문	*규문/NNG
규사	*규사/NNG
규소	*규소/NNG
규율	*규율/NNG
규정	*규정/NNG
규제	*규제/NNG
규지	*규지/NNG
규찰	*규찰/NNG
규칙	*규칙/NNG
규탄	*규탄/NNG
규합	*규합/NNG
규호	*규호/NNG
규환	*규환/NNG
균등	*균등/NNG
균분	*균분/NNG
균열	*균열/NNG
균일	*균일/NNG
균점	*균점/NNG
균정	*균정/NNG
균제	*균제/NNG
균질	*균질/NNG
그득	*그득/MAG
그뜩	*그뜩/MAG
그러	*그러/VV
그물	*그물/NNG
극간	*극간/NNG
극감	*극감/NNG
극기	*극기/NNG
극대	*극대/NNG
극력	*극력/NNG
극렬	*극렬/NNG
극명	*극명/NNG
극목	*극목/NNG
극복	*극복/NNG
극빈	*극빈/NNG
극상	*극상/NNG
극성	*극성/NNG
극소	*극소/NNG
극악	*극악/NNG
극언	*극언/NNG
극의	*극의/NNG
극일	*극일/NNG
극작	*극작/NNG
극지	*극지/NNG
극찬	*극찬/NNG
극치	*극치/NNG
극화	*극화/NNG
극흉	*극흉/NNG
근간	*근간/NNG
근거	*근거/NNG
근검	*근검/NNG
근경	*근경/NNG
근고	*근고/NNG
근공	*근공/NNG
근덕	*근덕/NNP
근로	*근로/NNG
근면	*근면/NNG
근무	*근무/NNG
근세	*근세/NNG
근속	*근속/NNG
근수	*근수/NNG
근시	*근시/NNG
근신	*근신/NNG
근심	*근심/NNG
근왕	*근왕/NNG
근원	*근원/NNG
근위	*근위/NNG
근절	*근절/NNG
근접	*근접/NNG
근정	*근정/NNG
근조	*근조/NNG
근종	*근종/NNG
근착	*근착/NNG
근친	*근친/NNG
근포	*근포/NNG
근행	*근행/NNP
글썽	*글썽/MAG
금계	*금계/NNG
금구	*금구/NNP
금기	*금기/NNG
금남	*금남/NNP
금납	*금납/NNG
금녀	*금녀/NNP
금단	*금단/NNG
금렵	*금렵/NNG
금박	*금박/NNG
금비	*금비/NNG
금생	*금생/NNG
금속	*금속/NNG
금송	*금송/NNG
금식	*금식/NNG
금실	*금실/NNG
금압	*금압/NNG
금어	*금어/NNG
금언	*금언/NNG
금연	*금연/NNG
금욕	*금욕/NNG
금장	*금장/NNG
금전	*금전/NNG
금제	*금제/NNG
금주	*금주/NNG
금지	*금지/NNG
금칙	*금칙/NNG
금칠	*금칠/NNG
금혼	*금혼/NNG
금화	*금화/NNG
금환	*금환/NNG
급감	*급감/NNG
급거	*급거/MAG
급구	*급구/NNG
급등	*급등/NNG
급락	*급락/NNG
급랭	*급랭/NNG
급료	*급료/NNG
급류	*급류/NNG
급매	*급매/NNG
급박	*급박/NNG
급변	*급변/NNG
급보	*급보/NNG
급부	*급부/NNG
급사	*급사/NNG
급서	*급서/NNG
급소	*급소/NNG
급속	*급속/NNG
급수	*급수/NNG
급습	*급습/NNG
급식	*급식/NNG
급여	*급여/NNG
급유	*급유/NNG
급장	*급장/NNG
급전	*급전/NNG
급제	*급제/NNG
급조	*급조/NNG
급주	*급주/NNG
급증	*급증/NNG
급진	*급진/NNG
급체	*급체/NNG
급파	*급파/NNG
급행	*급행/NNG
긍구	*긍구/NNG
긍정	*긍정/NNG
긍휼	*긍휼/NNG
기각	*기각/NNG
기간	*기간/NNG
기거	*기거/NNG
기겁	*기겁/NNG
기견	*기견/NNG
기고	*기고/NNG
기곡	*기곡/NNG
기공	*기공/NNG
기교	*기교/NNG
기권	*기권/NNG
기급	*기급/NNG
기기	*기기/NNG
기년	*기년/NNG
기념	*기념/NNG
기능	*기능/NNG
기단	*기단/NNG
기도	*기도/NNG
기동	*기동/NNG
기두	*기두/NNG
기득	*기득/NNG
기록	*기록/NNG
기롱	*기롱/NNG
기류	*기류/NNG
기름	*기름/NNG
기립	*기립/NNG
기마	*기마/NNG
기만	*기만/NNG
기망	*기망/NNG
기명	*기명/NNG
기묘	*기묘/NNG
기무	*기무/NNG
기문	*기문/NNG
기미	*기미/NNG
기민	*기민/NNG
기밀	*기밀/NNG
기발	*기발/NNG
기방	*기방/NNG
기변	*기변/NNG
기별	*기별/NNG
기병	*기병/NNG
기보	*기보/NNG
기복	*기복/NNG
기부	*기부/NNG
기사	*기사/NNG
기산	*기산/NNG
기상	*기상/NNG
기색	*기색/NNG
기생	*기생/NNG
기성	*기성/NNG
기세	*기세/NNG
기소	*기소/NNG
기속	*기속/NNG
기수	*기수/NNG
기숙	*기숙/NNG
기술	*기술/NNG
기습	*기습/NNG
기승	*기승/NNG
기식	*기식/NNG
기신	*기신/NNG
기실	*기실/MAG
기심	*기심/NNG
기아	*기아/NNG
기안	*기안/NNG
기약	*기약/NNG
기억	*기억/NNG
기언	*기언/NNG
기업	*기업/NNG
기여	*기여/NNG
기연	*기연/NNG
기예	*기예/NNG
기오	*기오/NNP
기옥	*기옥/NNP
기와	*기와/NNG
기용	*기용/NNG
기우	*기우/NNG
기웃	*기웃/MAG
기원	*기원/NNG
기위	*기위/MAG
기은	*기은/NNP
기음	*기음/NNG
기의	*기의/NNG
기인	*기인/NNG
기일	*기일/NNG
기입	*기입/NNG
기장	*기장/NNG
기재	*기재/NNG
기적	*기적/NNG
기전	*기전/NNG
기절	*기절/NNG
기정	*기정/NNG
기존	*기존/NNG
기종	*기종/NNG
기좌	*기좌/NNG
기주	*기주/NNG
기증	*기증/NNG
기지	*기지/NNG
기진	*기진/NNG
기착	*기착/NNG
기찰	*기찰/NNG
기참	*기참/NNG
기채	*기채/NNG
기척	*기척/NNG
기청	*기청/NNG
기초	*기초/NNG
기축	*기축/NNG
기치	*기치/NNG
기침	*기침/NNG
기탁	*기탁/NNG
기탄	*기탄/NNG
기포	*기포/NNG
기표	*기표/NNG
기풍	*기풍/NNG
기피	*기피/NNG
기필	*기필/NNG
기학	*기학/NNG
기한	*기한/NNG
기함	*기함/NNG
기항	*기항/NNG
기해	*기해/NNG
기허	*기허/NNG
기현	*기현/NNP
기협	*기협/NNG
기형	*기형/NNG
기호	*기호/NNG
기혼	*기혼/NNG
기화	*기화/NNG
기회	*기회/NNG
기획	*기획/NNG
기휘	*기휘/NNG
기흥	*기흥/NNP
긴급	*긴급/NNG
긴말	*긴말/NNG
긴박	*긴박/NNG
긴장	*긴장/NNG
긴축	*긴축/NNG
길상	*길상/NNG
길쌈	*길쌈/NNG
길항	*길항/NNG
김장	*김장/NNG
깁스	*깁스/NNG
까닥	*까닥/MAG
까딱	*까딱/MAG
까불	*까불/VV
까악	*까악/MAG
까옥	*까옥/MAG
까욱	*까욱/MAG
깍깍	*깍깍/MAG
깔딱	*깔딱/MAG
깜깜	*깜깜/MAG
깜박	*깜박/MAG
깜빡	*깜빡/MAG
깜작	*깜작/MAG
깜짝	*깜짝/MAG
깝신	*깝신/MAG
깡동	*깡동/MAG
깡총	*깡총/MAG
깡충	*깡충/MAG
깨갱	*깨갱/MAG
깨득	*깨득/MAG
깨죽	*깨죽/NNG
깩깩	*깩깩/MAG
꺼떡	*꺼떡/MAG
꺼먹	*꺼먹/NNG
꺽꺽	*꺽꺽/MAG
껄껄	*껄껄/MAG
껄렁	*껄렁/NNG
껌벅	*껌벅/MAG
껌뻑	*껌뻑/MAG
껌적	*껌적/MAG
껑청	*껑청/MAG
꼬박	*꼬박/MAG
꼭꼭	*꼭꼭/MAG
꼴값	*꼴값/NNG
꼴깍	*꼴깍/MAG
꼴꼴	*꼴꼴/MAG
꼴딱	*꼴딱/MAG
꼼꼼	*꼼꼼/MAG
꼼작	*꼼작/MAG
꼼짝	*꼼짝/MAG
꽁꽁	*꽁꽁/MAG
꽁알	*꽁알/NNG
꽃샘	*꽃샘/NNG
꽈당	*꽈당/MAG
꽐꽐	*꽐꽐/MAG
꽝꽝	*꽝꽝/MAG
꽝당	*꽝당/MAG
꽥꽥	*꽥꽥/MAG
꽹꽹	*꽹꽹/MAG
꾀병	*꾀병/NNG
꾸꾸	*꾸꾸/MAG
꾸륵	*꾸륵/MAG
꾸벅	*꾸벅/MAG
꾸뻑	*꾸뻑/MAG
꾸중	*꾸중/NNG
꾹꾹	*꾹꾹/MAG
꿀꺽	*꿀꺽/MAG
꿀꿀	*꿀꿀/MAG
꿀떡	*꿀떡/MAG
꿈적	*꿈적/MAG
꿈질	*꿈질/MAG
꿈쩍	*꿈쩍/MAG
꿈틀	*꿈틀/MAG
꿍꿍	*꿍꿍/MAG
끄덕	*끄덕/MAG
끄떡	*끄떡/MAG
끅끅	*끅끅/MAG
끌끌	*끌끌/MAG
끌탕	*끌탕/NNG
끔뻑	*끔뻑/MAG
끙끙	*끙끙/MAG
끼익	*끼익/MAG
끽끽	*끽끽/MAG
끽다	*끽다/NNG
끽연	*끽연/NNG
낄낄	*낄낄/MAG
낑낑	*낑낑/MAG
나농	*나농/NNG
나대	*나대/VV
나락	*나락/NNG
나루	*나루/NNG
나무	*나무/NNG
나물	*나물/NNG
나약	*나약/NNG
나열	*나열/NNG
나용	*나용/NNG
나이	*나이/NNG
나인	*나인/NNG
나장	*나장/NNG
나진	*나진/NNP
나치	*나치/NNP
나타	*나타/NNP
나탈	*나탈/NNP
나태	*나태/NNG
나파	*나파/NNP
나팔	*나팔/NNG
나포	*나포/NNG
낙과	*낙과/NNG
낙관	*낙관/NNG
낙담	*낙담/NNG
낙뢰	*낙뢰/NNG
낙루	*낙루/NNG
낙마	*낙마/NNG
낙망	*낙망/NNG
낙명	*낙명/NNG
낙반	*낙반/NNG
낙발	*낙발/NNG
낙방	*낙방/NNG
낙백	*낙백/NNG
낙사	*낙사/NNG
낙산	*낙산/NNP
낙상	*낙상/NNG
낙서	*낙서/NNG
낙선	*낙선/NNG
낙성	*낙성/NNG
낙수	*낙수/NNG
낙승	*낙승/NNG
낙심	*낙심/NNG
낙오	*낙오/NNG
낙일	*낙일/NNG
낙점	*낙점/NNG
낙제	*낙제/NNG
낙지	*낙지/NNG
낙착	*낙착/NNG
낙찰	*낙찰/NNG
낙척	*낙척/NNG
낙천	*낙천/NNG
낙치	*낙치/NNG
낙타	*낙타/NNG
낙태	*낙태/NNG
낙하	*낙하/NNG
낙향	*낙향/NNG
낙화	*낙화/NNG
낙후	*낙후/NNG
낚시	*낚시/NNG
난간	*난간/NNG
난교	*난교/NNG
난당	*난당/NNG
난도	*난도/NNG
난동	*난동/NNG
난륜	*난륜/NNG
난리	*난리/NNG
난립	*난립/NNG
난만	*난만/NNG
난망	*난망/NNG
난무	*난무/NNG
난부	*난부/NNP
난비	*난비/NNG
난사	*난사/NNG
난산	*난산/NNG
난상	*난상/NNG
난숙	*난숙/NNG
난음	*난음/NNG
난익	*난익/NNG
난입	*난입/NNG
난자	*난자/NNG
난전	*난전/NNG
난정	*난정/NNG
난조	*난조/NNG
난초	*난초/NNG
난치	*난치/NNG
난타	*난타/NNG
난투	*난투/NNG
난파	*난파/NNG
난폭	*난폭/NNG
난행	*난행/NNG
난화	*난화/NNG
날염	*날염/NNG
날인	*날인/NNG
날조	*날조/NNG
남고	*남고/NNG
남남	*남남/NNG
남도	*남도/NNG
남루	*남루/NNG
남류	*남류/NNG
남면	*남면/NNP
남발	*남발/NNG
남벌	*남벌/NNG
남분	*남분/NNG
남실	*남실/NNG
남악	*남악/NNP
남용	*남용/NNG
남작	*남작/NNG
남장	*남장/NNG
남정	*남정/NNG
남조	*남조/NNP
남중	*남중/NNG
남진	*남진/NNG
남짓	*남짓/NNB
남침	*남침/NNG
남파	*남파/NNG
남하	*남하/NNG
남행	*남행/NNG
남향	*남향/NNG
남획	*남획/NNG
납골	*납골/NNG
납관	*납관/NNG
납금	*납금/NNG
납길	*납길/NNG
납두	*납두/NNG
납득	*납득/NNG
납땜	*납땜/NNG
납량	*납량/NNG
납본	*납본/NNG
납부	*납부/NNG
납북	*납북/NNG
납세	*납세/NNG
납속	*납속/NNG
납의	*납의/NNG
납입	*납입/NNG
납징	*납징/NNG
납채	*납채/NNG
납치	*납치/NNG
납폐	*납폐/NNG
납품	*납품/NNG
낭독	*낭독/NNG
낭비	*낭비/NNG
낭송	*낭송/NNG
낭자	*낭자/NNG
낭창	*낭창/NNG
낭패	*낭패/NNG
내강	*내강/NNG
내공	*내공/NNG
내관	*내관/NNG
내구	*내구/NNG
내근	*내근/NNG
내기	*내기/NNG
내도	*내도/NNG
내동	*내동/NNP
내락	*내락/NNG
내림	*내림/NNG
내발	*내발/NNG
내방	*내방/NNG
내배	*내배/VV
내보	*내보/VV
내복	*내복/NNG
내부	*내부/NNG
내분	*내분/NNG
내빈	*내빈/NNG
내사	*내사/NNG
내색	*내색/NNG
내생	*내생/NNG
내서	*내서/NNG
내선	*내선/NNG
내성	*내성/NNG
내소	*내소/NNG
내수	*내수/NNG
내숭	*내숭/NNG
내습	*내습/NNG
내시	*내시/NNG
내식	*내식/NNG
내신	*내신/NNG
내약	*내약/NNG
내연	*내연/NNG
내열	*내열/NNG
내왕	*내왕/NNG
내외	*내외/NNG
내용	*내용/NNG
내우	*내우/NNG
내원	*내원/NNG
내응	*내응/NNG
내인	*내인/NNG
내장	*내장/NNG
내재	*내재/NNG
내전	*내전/NNG
내점	*내점/NNG
내접	*내접/NNG
내정	*내정/NNG
내조	*내조/NNG
내진	*내진/NNG
내차	*내차/VV
내처	*내처/MAG
내친	*내친/NNG
내침	*내침/NNG
내탁	*내탁/NNG
내통	*내통/NNG
내포	*내포/NNG
내핍	*내핍/NNG
내한	*내한/NNG
내항	*내항/NNG
내향	*내향/NNG
내화	*내화/NNG
냉각	*냉각/NNG
냉담	*냉담/NNG
냉대	*냉대/NNG
냉동	*냉동/NNG
냉매	*냉매/NNG
냉소	*냉소/NNG
냉시	*냉시/NNG
냉연	*냉연/NNG
냉장	*냉장/NNG
냉정	*냉정/NNG
냉한	*냉한/NNG
냠냠	*냠냠/MAG
너덜	*너덜/NNG
너무	*너무/MAG
너울	*너울/NNG
넙적	*넙적/MAG
넙죽	*넙죽/MAG
노견	*노견/NNG
노고	*노고/NNG
노광	*노광/NNG
노노	*노노/NNG
노대	*노대/NNG
노동	*노동/NNG
노둔	*노둔/NNG
노략	*노략/NNG
노력	*노력/NNG
노름	*노름/NNG
노망	*노망/NNG
노면	*노면/NNG
노무	*노무/NNG
노문	*노문/NNG
노박	*노박/NNP
노발	*노발/NNP
노사	*노사/NNG
노산	*노산/NNG
노성	*노성/NNG
노쇠	*노쇠/NNG
노신	*노신/NNP
노심	*노심/NNG
노약	*노약/NNG
노역	*노역/NNG
노원	*노원/NNP
노작	*노작/NNG
노장	*노장/NNG
노적	*노적/NNG
노정	*노정/NNG
노제	*노제/NNG
노좌	*노좌/NNG
노차	*노차/NNP
노창	*노창/NNG
노처	*노처/NNG
노추	*노추/NNG
노출	*노출/NNG
노크	*노크/NNG
노트	*노트/NNG
노포	*노포/NNG
노해	*노해/NNG
노현	*노현/NNG
노호	*노호/NNG
노혼	*노혼/NNG
노화	*노화/NNG
노획	*노획/NNG
노후	*노후/NNG
녹사	*녹사/NNG
녹수	*녹수/NNG
녹용	*녹용/NNG
녹음	*녹음/NNG
녹진	*녹진/NNP
녹차	*녹차/NNG
녹취	*녹취/NNG
녹화	*녹화/NNG
녹훈	*녹훈/NNG
논고	*논고/NNG
논급	*논급/NNG
논단	*논단/NNG
논담	*논담/NNG
논란	*논란/NNG
논박	*논박/NNG
논변	*논변/NNG
논설	*논설/NNG
논술	*논술/NNG
논의	*논의/NNG
논일	*논일/NNG
논쟁	*논쟁/NNG
논저	*논저/NNG
논전	*논전/NNG
논정	*논정/NNG
논죄	*논죄/NNG
논증	*논증/NNG
논지	*논지/NNG
논진	*논진/NNG
논집	*논집/NNG
논파	*논파/NNG
논평	*논평/NNG
논핵	*논핵/NNG
놀음	*놀음/NNG
놀이	*놀이/NNG
농간	*농간/NNG
농감	*농감/NNG
농경	*농경/NNG
농구	*농구/NNG
농기	*농기/NNG
농단	*농단/NNG
농담	*농담/NNG
농락	*농락/NNG
농밀	*농밀/NNG
농반	*농반/NNG
농법	*농법/NNG
농사	*농사/NNG
농성	*농성/NNG
농양	*농양/NNG
농염	*농염/NNG
농작	*농작/NNG
농장	*농장/NNG
농축	*농축/NNG
농탕	*농탕/NNG
농현	*농현/NNG
농후	*농후/NNG
뇌각	*뇌각/NNG
뇌동	*뇌동/NNG
뇌사	*뇌사/NNG
뇌쇄	*뇌쇄/NNG
뇌수	*뇌수/NNG
뇌신	*뇌신/NNG
뇌주	*뇌주/NNG
뇌호	*뇌호/NNG
누각	*누각/NNG
누계	*누계/NNG
누고	*누고/NNG
누공	*누공/NNG
누덕	*누덕/NNG
누락	*누락/NNG
누문	*누문/NNG
누범	*누범/NNG
누보	*누보/NNG
누설	*누설/NNG
누승	*누승/NNG
누실	*누실/NNG
누적	*누적/NNG
누전	*누전/NNG
누정	*누정/NNG
누증	*누증/NNG
누진	*누진/NNG
누출	*누출/NNG
눈짓	*눈짓/NNG
느끼	*느끼/VV
늑탈	*늑탈/NNG
능가	*능가/NNG
능견	*능견/NNG
능력	*능력/NNG
능멸	*능멸/NNG
능욕	*능욕/NNG
능전	*능전/NNG
능지	*능지/NNG
능청	*능청/NNG
능행	*능행/NNG
다각	*다각/NNG
다공	*다공/NNG
다구	*다구/NNP
다기	*다기/NNG
다남	*다남/NNG
다능	*다능/NNG
다다	*다다/NNG
다단	*다단/NNG
다달	*다달/NNG
다대	*다대/NNG
다독	*다독/NNG
다망	*다망/NNG
다면	*다면/NNG
다발	*다발/NNG
다변	*다변/NNG
다복	*다복/NNG
다상	*다상/NNG
다솔	*다솔/NNG
다수	*다수/NNG
다스	*다스/NNB
다식	*다식/NNG
다양	*다양/NNG
다언	*다언/NNG
다예	*다예/NNG
다음	*다음/NNG
다의	*다의/NNG
다이	*다이/NNG
다작	*다작/NNG
다재	*다재/NNG
다점	*다점/NNG
다정	*다정/NNG
다족	*다족/NNG
다종	*다종/NNG
다지	*다지/VV
다짐	*다짐/NNG
다툼	*다툼/NNG
다행	*다행/NNG
닦달	*닦달/NNG
단견	*단견/NNG
단결	*단결/NNG
단경	*단경/NNG
단공	*단공/NNG
단과	*단과/NNG
단교	*단교/NNG
단기	*단기/NNG
단념	*단념/NNG
단락	*단락/NNG
단련	*단련/NNG
단명	*단명/NNG
단문	*단문/NNG
단발	*단발/NNG
단방	*단방/NNG
단배	*단배/NNG
단비	*단비/NNG
단산	*단산/NNG
단상	*단상/NNG
단선	*단선/NNG
단설	*단설/NNG
단소	*단소/NNG
단속	*단속/NNG
단수	*단수/NNG
단순	*단순/NNG
단식	*단식/NNG
단신	*단신/NNG
단안	*단안/NNG
단언	*단언/NNG
단연	*단연/MAG
단열	*단열/NNG
단원	*단원/NNG
단음	*단음/NNG
단일	*단일/NNG
단작	*단작/NNG
단장	*단장/NNG
단재	*단재/NNP
단전	*단전/NNG
단절	*단절/NNG
단정	*단정/NNG
단조	*단조/NNG
단종	*단종/NNP
단좌	*단좌/NNG
단죄	*단죄/NNG
단주	*단주/NNG
단차	*단차/NNG
단천	*단천/NNP
단청	*단청/NNG
단축	*단축/NNG
단평	*단평/NNG
단학	*단학/NNG
단합	*단합/NNG
단행	*단행/NNG
단형	*단형/NNG
단화	*단화/NNG
달관	*달관/NNG
달서	*달서/NNP
달성	*달성/NNG
달싹	*달싹/MAG
달칵	*달칵/MAG
달통	*달통/NNG
달하	*달하/VV
담당	*담당/NNG
담론	*담론/NNG
담박	*담박/NNG
담보	*담보/NNG
담뿍	*담뿍/MAG
담세	*담세/NNG
담소	*담소/NNG
담수	*담수/NNG
담여	*담여/NNG
담염	*담염/NNG
담임	*담임/NNG
담장	*담장/NNG
담판	*담판/NNG
담합	*담합/NNG
담화	*담화/NNG
답교	*답교/NNG
답례	*답례/NNG
답방	*답방/NNG
답배	*답배/NNG
답변	*답변/NNG
답보	*답보/NNG
답사	*답사/NNG
답산	*답산/NNG
답서	*답서/NNG
답습	*답습/NNG
답신	*답신/NNG
답인	*답인/NNG
답장	*답장/NNG
답전	*답전/NNG
답지	*답지/NNG
답청	*답청/NNP
당가	*당가/NNG
당고	*당고/NNG
당국	*당국/NNG
당당	*당당/MAG
당면	*당면/NNG
당목	*당목/NNG
당무	*당무/NNG
당번	*당번/NNG
당부	*당부/NNG
당사	*당사/NNG
당상	*당상/NNG
당색	*당색/NNG
당선	*당선/NNG
당시	*당시/NNG
당싯	*당싯/MAG
당우	*당우/NNG
당월	*당월/NNG
당중	*당중/NNG
당직	*당직/NNG
당차	*당차/VA
당착	*당착/NNG
당첨	*당첨/NNG
당파	*당파/NNG
당혹	*당혹/NNG
당화	*당화/NNG
당황	*당황/NNG
대각	*대각/NNG
대간	*대간/NNG
대갈	*대갈/NNG
대검	*대검/NNG
대결	*대결/NNG
대경	*대경/NNG
대곡	*대곡/NNG
대과	*대과/NNG
대관	*대관/NNG
대교	*대교/NNG
대국	*대국/NNG
대금	*대금/NNG
대기	*대기/NNG
대길	*대길/NNG
대꾸	*대꾸/NNG
대납	*대납/NNG
대담	*대담/NNG
대답	*대답/NNG
대당	*대당/NNG
대대	*대대/NNG
대도	*대도/NNG
대독	*대독/NNG
대동	*대동/NNG
대두	*대두/NNG
대등	*대등/NNG
대란	*대란/NNG
대련	*대련/NNP
대렴	*대렴/NNG
대령	*대령/NNG
대롱	*대롱/NNG
대립	*대립/NNG
대망	*대망/NNG
대매	*대매/NNG
대맥	*대맥/NNG
대면	*대면/NNG
대명	*대명/NNG
대물	*대물/NNG
대발	*대발/NNG
대방	*대방/NNG
대번	*대번/MAG
대변	*대변/NNG
대별	*대별/NNG
대본	*대본/NNG
대봉	*대봉/NNP
대부	*대부/NNG
대비	*대비/NNG
대사	*대사/NNG
대살	*대살/NNG
대상	*대상/NNG
대석	*대석/NNG
대성	*대성/NNG
대소	*대소/NNG
대속	*대속/NNG
대수	*대수/NNG
대승	*대승/NNG
대시	*대시/NNG
대식	*대식/NNG
대신	*대신/NNG
대안	*대안/NNG
대양	*대양/NNG
대어	*대어/NNG
대여	*대여/NNG
대역	*대역/NNG
대열	*대열/NNG
대오	*대오/NNG
대용	*대용/NNG
대우	*대우/NNP
대원	*대원/NNG
대위	*대위/NNG
대응	*대응/NNG
대의	*대의/NNG
대인	*대인/NNG
대입	*대입/NNG
대자	*대자/NNG
대작	*대작/NNG
대장	*대장/NNG
대적	*대적/NNG
대절	*대절/NNG
대접	*대접/NNG
대정	*대정/NNG
대조	*대조/NNG
대좌	*대좌/NNG
대주	*대주/NNG
대중	*대중/NNG
대증	*대증/NNG
대지	*대지/NNG
대진	*대진/NNG
대질	*대질/NNG
대찰	*대찰/NNG
대창	*대창/NNG
대책	*대책/NNG
대척	*대척/NNG
대첩	*대첩/NNG
대청	*대청/NNG
대추	*대추/NNG
대춘	*대춘/NNG
대출	*대출/NNG
대충	*대충/MAG
대취	*대취/NNG
대치	*대치/NNG
대칭	*대칭/NNG
대타	*대타/NNG
대탑	*대탑/NNG
대토	*대토/NNG
대통	*대통/NNG
대파	*대파/NNG
대판	*대판/NNG
대패	*대패/NNG
대표	*대표/NNG
대피	*대피/NNG
대필	*대필/NNG
대항	*대항/NNG
대행	*대행/NNG
대향	*대향/NNG
대호	*대호/NNG
대혹	*대혹/NNG
대화	*대화/NNG
대황	*대황/NNG
대후	*대후/NNG
대흥	*대흥/NNG
대희	*대희/NNP
댕강	*댕강/MAG
더듬	*더듬/VV
더럭	*더럭/MAG
더빙	*더빙/NNG
더위	*더위/NNG
덕담	*덕담/NNG
덕대	*덕대/NNG
덕화	*덕화/NNG
덜덜	*덜덜/MAG
덜렁	*덜렁/MAG
덜썩	*덜썩/MAG
덜컥	*덜컥/MAG
덜컹	*덜컹/MAG
덤핑	*덤핑/NNG
덥석	*덥석/MAG
덧셈	*덧셈/NNG
덧칠	*덧칠/NNG
덩실	*덩실/MAG
데모	*데모/NNG
데뷔	*데뷔/NNG
뎅겅	*뎅겅/MAG
뎅뎅	*뎅뎅/MAG
도강	*도강/NNG
도견	*도견/NNP
도계	*도계/NNG
도고	*도고/NNG
도과	*도과/NNG
도광	*도광/NNG
도괴	*도괴/NNG
도구	*도구/NNG
도굴	*도굴/NNG
도금	*도금/NNG
도급	*도급/NNG
도기	*도기/NNG
도달	*도달/NNG
도독	*도독/NNG
도랑	*도랑/NNG
도래	*도래/NNG
도련	*도련/NNG
도록	*도록/NNG
도루	*도루/NNG
도륙	*도륙/NNG
도립	*도립/NNG
도말	*도말/NNG
도망	*도망/NNG
도매	*도매/NNG
도면	*도면/NNG
도무	*도무/NNP
도문	*도문/NNP
도미	*도미/NNG
도박	*도박/NNG
도발	*도발/NNG
도배	*도배/NNG
도벌	*도벌/NNG
도벽	*도벽/NNG
도병	*도병/NNG
도보	*도보/NNG
도복	*도복/NNG
도봉	*도봉/NNG
도부	*도부/NNG
도비	*도비/NNG
도사	*도사/NNG
도살	*도살/NNG
도상	*도상/NNG
도색	*도색/NNG
도생	*도생/NNG
도서	*도서/NNG
도설	*도설/NNG
도섭	*도섭/NNG
도성	*도성/NNG
도세	*도세/NNG
도솔	*도솔/NNP
도수	*도수/NNG
도습	*도습/NNG
도승	*도승/NNG
도식	*도식/NNG
도신	*도신/NNG
도안	*도안/NNG
도야	*도야/NNG
도약	*도약/NNG
도열	*도열/NNG
도용	*도용/NNG
도유	*도유/NNG
도읍	*도읍/NNG
도의	*도의/NNG
도이	*도이/NNP
도인	*도인/NNG
도일	*도일/NNG
도임	*도임/NNG
도입	*도입/NNG
도작	*도작/NNG
도장	*도장/NNG
도적	*도적/NNG
도전	*도전/NNG
도정	*도정/NNG
도제	*도제/NNG
도집	*도집/NNG
도착	*도착/NNG
도철	*도철/NNP
도청	*도청/NNG
도축	*도축/NNG
도출	*도출/NNG
도취	*도취/NNG
도치	*도치/NNG
도킹	*도킹/NNG
도타	*도타/NNG
도태	*도태/NNG
도포	*도포/NNG
도피	*도피/NNG
도하	*도하/NNG
도항	*도항/NNG
도해	*도해/NNG
도현	*도현/NNP
도화	*도화/NNG
도회	*도회/NNG
독거	*독거/NNG
독경	*독경/NNG
독단	*독단/NNG
독대	*독대/NNG
독도	*독도/NNP
독려	*독려/NNG
독력	*독력/NNG
독립	*독립/NNG
독무	*독무/NNG
독배	*독배/NNG
독백	*독백/NNG
독보	*독보/NNG
독사	*독사/NNG
독살	*독살/NNG
독서	*독서/NNG
독설	*독설/NNG
독소	*독소/NNG
독수	*독수/NNG
독습	*독습/NNG
독시	*독시/NNG
독식	*독식/NNG
독신	*독신/NNG
독실	*독실/NNG
독어	*독어/NNP
독연	*독연/NNP
독음	*독음/NNG
독작	*독작/NNG
독재	*독재/NNG
독전	*독전/NNG
독점	*독점/NNG
독존	*독존/NNG
독좌	*독좌/NNG
독주	*독주/NNG
독지	*독지/NNG
독직	*독직/NNG
독창	*독창/NNG
독처	*독처/NNG
독촉	*독촉/NNG
독축	*독축/NNG
독침	*독침/NNG
독탕	*독탕/NNG
독특	*독특/NNG
독파	*독파/NNG
독학	*독학/NNG
독해	*독해/NNG
독화	*독화/NNG
독후	*독후/NNG
돈대	*돈대/NNG
돈독	*돈독/NNG
돈반	*돈반/NNG
돈사	*돈사/NNG
돈세	*돈세/NNG
돈수	*돈수/NNG
돈오	*돈오/NNG
돈절	*돈절/NNG
돈화	*돈화/NNP
돈후	*돈후/NNG
돌격	*돌격/NNG
돌기	*돌기/NNG
돌돌	*돌돌/MAG
돌발	*돌발/NNG
돌변	*돌변/NNG
돌비	*돌비/NNG
돌연	*돌연/MAG
돌입	*돌입/NNG
돌진	*돌진/NNG
돌창	*돌창/NNG
돌출	*돌출/NNG
돌탄	*돌탄/NNG
돌파	*돌파/NNG
동감	*동감/NNG
동갑	*동갑/NNG
동거	*동거/NNG
동결	*동결/NNG
동경	*동경/NNP
동고	*동고/NNG
동과	*동과/NNG
동귀	*동귀/NNG
동글	*동글/VA
동냥	*동냥/NNG
동당	*동당/NNG
동도	*동도/NNG
동독	*동독/NNP
동등	*동등/NNG
동락	*동락/NNG
동래	*동래/NNP
동량	*동량/NNG
동력	*동력/NNG
동렬	*동렬/NNG
동류	*동류/NNG
동맹	*동맹/NNG
동면	*동면/NNG
동모	*동모/NNG
동무	*동무/NNG
동반	*동반/NNG
동봉	*동봉/NNG
동부	*동부/NNG
동분	*동분/NNG
동사	*동사/NNG
동석	*동석/NNG
동선	*동선/NNG
동숙	*동숙/NNG
동시	*동시/NNG
동심	*동심/NNG
동양	*동양/NNG
동업	*동업/NNG
동연	*동연/NNP
동요	*동요/NNG
동우	*동우/NNG
동원	*동원/NNG
동의	*동의/NNG
동인	*동인/NNG
동일	*동일/NNG
동자	*동자/NNG
동작	*동작/NNG
동장	*동장/NNG
동재	*동재/NNG
동전	*동전/NNG
동점	*동점/NNG
동접	*동접/NNG
동정	*동정/NNG
동조	*동조/NNG
동주	*동주/NNG
동진	*동진/NNG
동차	*동차/NNG
동참	*동참/NNG
동천	*동천/NNG
동침	*동침/NNG
동탁	*동탁/NNP
동토	*동토/NNG
동포	*동포/NNG
동학	*동학/NNG
동한	*동한/NNG
동행	*동행/NNG
동향	*동향/NNG
동혈	*동혈/NNG
동호	*동호/NNP
동화	*동화/NNG
동회	*동회/NNG
되똑	*되똑/MAG
두둑	*두둑/NNG
두둔	*두둔/NNG
두량	*두량/NNG
두레	*두레/NNG
두류	*두류/NNG
두말	*두말/NNG
두선	*두선/NNP
두수	*두수/NNG
두식	*두식/NNG
두절	*두절/NNG
둔감	*둔감/NNG
둔갑	*둔갑/NNG
둔거	*둔거/NNG
둔주	*둔주/NNG
둔취	*둔취/NNG
둔화	*둔화/NNG
둘둘	*둘둘/MAG
둥글	*둥글/VA
둥둥	*둥둥/MAG
둥실	*둥실/MAG
둥싯	*둥싯/MAG
뒤뚱	*뒤뚱/MAG
뒤쪽	*뒤쪽/NNG
뒤척	*뒤척/MAG
뒷말	*뒷말/NNG
뒷물	*뒷물/NNG
드난	*드난/NNG
득남	*득남/NNG
득달	*득달/NNG
득도	*득도/NNG
득병	*득병/NNG
득세	*득세/NNG
득시	*득시/NNG
득실	*득실/NNG
득오	*득오/NNP
득음	*득음/NNG
득의	*득의/NNG
득점	*득점/NNG
득책	*득책/NNG
득표	*득표/NNG
들들	*들들/MAG
들먹	*들먹/VV
들메	*들메/NNG
들썩	*들썩/MAG
들일	*들일/NNG
듬뿍	*듬뿍/MAG
등과	*등과/NNG
등교	*등교/NNG
등귀	*등귀/NNG
등극	*등극/NNG
등기	*등기/NNG
등단	*등단/NNG
등대	*등대/NNG
등등	*등등/NNB
등락	*등락/NNG
등록	*등록/NNG
등문	*등문/NNP
등반	*등반/NNG
등본	*등본/NNG
등분	*등분/NNG
등사	*등사/NNG
등산	*등산/NNG
등상	*등상/NNG
등선	*등선/NNG
등성	*등성/NNB
등용	*등용/NNG
등원	*등원/NNG
등위	*등위/NNG
등장	*등장/NNG
등재	*등재/NNG
등정	*등정/NNG
등제	*등제/NNG
등주	*등주/NNP
등척	*등척/NNG
등천	*등천/NNG
등청	*등청/NNG
등판	*등판/NNG
따끔	*따끔/MAG
딱딱	*딱딱/MAG
딴말	*딴말/NNG
딴짓	*딴짓/NNG
딸각	*딸각/MAG
딸깍	*딸깍/MAG
딸꾹	*딸꾹/MAG
딸딸	*딸딸/MAG
딸칵	*딸칵/MAG
딸랑	*딸랑/MAG
땅땅	*땅땅/MAG
때뚝	*때뚝/MAG
땡땡	*땡땡/MAG
떠세	*떠세/NNG
떡떡	*떡떡/MAG
떡칠	*떡칠/NNG
떨떨	*떨떨/MAG
떨이	*떨이/NNG
또각	*또각/MAG
또박	*또박/MAG
똑똑	*똑똑/MAG
똘똘	*똘똘/MAG
똥똥	*똥똥/MAG
똥칠	*똥칠/NNG
뚜벅	*뚜벅/MAG
뚝딱	*뚝딱/MAG
뚝뚝	*뚝뚝/MAG
뚤뚤	*뚤뚤/MAG
뚱땅	*뚱땅/MAG
뚱뚱	*뚱뚱/MAG
뜨끔	*뜨끔/MAG
뜀질	*뜀질/NNG
띵띵	*띵띵/MAG
락관	*락관/NNG
란자	*란자/NNP
력사	*력사/NNG
련재	*련재/NNG
로동	*로동/NNG
로망	*로망/NNG
로비	*로비/NNG
로제	*로제/NNP
로차	*로차/NNP
롱간	*롱간/NNG
롱런	*롱런/NNG
루고	*루고/NNG
루실	*루실/NNP
루진	*루진/NNP
류동	*류동/NNG
륜차	*륜차/NNG
리드	*리드/NNG
리해	*리해/NNG
림화	*림화/NNP
마감	*마감/NNG
마름	*마름/NNG
마마	*마마/NNG
마멸	*마멸/NNG
마모	*마모/NNG
마비	*마비/NNG
마사	*마사/NNP
마석	*마석/NNP
마쇄	*마쇄/NNG
마수	*마수/NNG
마술	*마술/NNG
마애	*마애/NNG
마장	*마장/NNB
마전	*마전/NNG
마제	*마제/NNG
마주	*마주/MAG
마중	*마중/NNG
마찰	*마찰/NNG
마취	*마취/NNG
마침	*마침/MAG
마크	*마크/NNG
막강	*막강/NNG
막급	*막급/NNG
막대	*막대/NNG
막말	*막말/NNG
막설	*막설/NNG
막일	*막일/NNG
만가	*만가/NNG
만개	*만개/NNG
만곡	*만곡/NNG
만공	*만공/NNP
만과	*만과/NNG
만근	*만근/NNG
만끽	*만끽/NNG
만능	*만능/NNG
만담	*만담/NNG
만당	*만당/NNG
만료	*만료/NNG
만류	*만류/NNG
만면	*만면/NNG
만무	*만무/NNG
만물	*만물/NNG
만반	*만반/NNG
만발	*만발/NNG
만보	*만보/NNG
만복	*만복/NNG
만사	*만사/NNG
만삭	*만삭/NNG
만선	*만선/NNG
만성	*만성/NNG
만수	*만수/NNG
만신	*만신/NNG
만안	*만안/NNG
만연	*만연/NNG
만유	*만유/NNG
만인	*만인/NNG
만일	*만일/NNG
만장	*만장/NNG
만재	*만재/NNG
만적	*만적/NNP
만전	*만전/NNG
만정	*만정/NNG
만조	*만조/NNG
만족	*만족/NNG
만주	*만주/NNP
만중	*만중/NNP
만지	*만지/VV
만천	*만천/NNP
만취	*만취/NNG
만평	*만평/NNG
만학	*만학/NNG
만행	*만행/NNG
만혼	*만혼/NNG
만화	*만화/NNG
만회	*만회/NNG
말감	*말감/NNG
말똥	*말똥/NNG
말벗	*말벗/NNG
말살	*말살/NNG
말소	*말소/NNG
말쌈	*말쌈/NNG
말씀	*말씀/NNG
말질	*말질/NNG
말짱	*말짱/MAG
말캉	*말캉/NNG
망가	*망가/NNG
망각	*망각/NNG
망고	*망고/NNG
망국	*망국/NNG
망단	*망단/NNG
망동	*망동/NNG
망라	*망라/NNG
망령	*망령/NNG
망막	*망막/NNG
망명	*망명/NNG
망모	*망모/NNG
망발	*망발/NNG
망사	*망사/NNG
망상	*망상/NNG
망신	*망신/NNG
망실	*망실/NNG
망아	*망아/NNG
망언	*망언/NNG
망예	*망예/NNG
망운	*망운/NNG
망월	*망월/NNG
망은	*망은/NNG
망일	*망일/NNG
망정	*망정/NNB
망조	*망조/NNG
망주	*망주/NNG
망집	*망집/NNG
망향	*망향/NNG
맞이	*맞이/NNG
맞절	*맞절/NNG
맞춤	*맞춤/NNG
매각	*매각/NNG
매개	*매개/NNG
매국	*매국/NNG
매도	*매도/NNG
매득	*매득/NNG
매련	*매련/NNG
매롱	*매롱/NNG
매료	*매료/NNG
매리	*매리/NNP
매립	*매립/NNG
매매	*매매/NNG
매명	*매명/NNG
매몰	*매몰/NNG
매복	*매복/NNG
매상	*매상/NNG
매석	*매석/NNG
매설	*매설/NNG
매수	*매수/NNG
매식	*매식/NNG
매신	*매신/NNP
매안	*매안/NNG
매약	*매약/NNG
매우	*매우/MAG
매원	*매원/NNG
매음	*매음/NNG
매이	*매이/VV
매입	*매입/NNG
매장	*매장/NNG
매점	*매점/NNG
매정	*매정/NNG
매직	*매직/NNG
매진	*매진/NNG
매집	*매집/NNG
매축	*매축/NNG
매춘	*매춘/NNG
매출	*매출/NNG
매치	*매치/NNG
매표	*매표/NNG
매향	*매향/NNG
매혹	*매혹/NNG
매혼	*매혼/NNG
매휴	*매휴/NNG
맥동	*맥동/NNG
맥진	*맥진/NNG
맥질	*맥질/NNG
맴매	*맴매/NNG
맹독	*맹독/NNG
맹동	*맹동/NNG
맹사	*맹사/NNG
맹성	*맹성/NNG
맹세	*맹세/NNG
맹신	*맹신/NNG
맹약	*맹약/NNG
맹장	*맹장/NNG
맹종	*맹종/NNG
맹타	*맹타/NNG
맹폭	*맹폭/NNG
맹휴	*맹휴/NNG
머리	*머리/NNG
먹칠	*먹칠/NNG
멀리	*멀리/MAG
멀미	*멀미/NNG
멈칫	*멈칫/MAG
멍군	*멍군/NNG
메모	*메모/NNG
메질	*메질/NNG
면결	*면결/NNG
면관	*면관/NNG
면괴	*면괴/NNG
면난	*면난/NNG
면담	*면담/NNG
면대	*면대/NNG
면도	*면도/NNG
면례	*면례/NNG
면면	*면면/NNG
면모	*면모/NNG
면박	*면박/NNG
면벽	*면벽/NNG
면봉	*면봉/NNG
면사	*면사/NNG
면상	*면상/NNG
면석	*면석/NNG
면세	*면세/NNG
면소	*면소/NNG
면수	*면수/NNG
면식	*면식/NNG
면신	*면신/NNG
면역	*면역/NNG
면유	*면유/NNG
면전	*면전/NNG
면접	*면접/NNG
면제	*면제/NNG
면종	*면종/NNG
면죄	*면죄/NNG
면주	*면주/NNG
면직	*면직/NNG
면책	*면책/NNG
면천	*면천/NNG
면청	*면청/NNG
면추	*면추/NNG
면탈	*면탈/NNG
면포	*면포/NNG
면피	*면피/NNG
면학	*면학/NNG
면허	*면허/NNG
면화	*면화/NNG
면회	*면회/NNG
멸각	*멸각/NNG
멸공	*멸공/NNG
멸구	*멸구/NNG
멸균	*멸균/NNG
멸망	*멸망/NNG
멸문	*멸문/NNG
멸시	*멸시/NNG
멸실	*멸실/NNG
멸절	*멸절/NNG
멸족	*멸족/NNG
멸종	*멸종/NNG
명가	*명가/NNG
명감	*명감/NNG
명검	*명검/NNG
명경	*명경/NNG
명계	*명계/NNG
명고	*명고/NNG
명기	*명기/NNG
명념	*명념/NNG
명단	*명단/NNG
명답	*명답/NNG
명도	*명도/NNG
명동	*명동/NNP
명랑	*명랑/NNG
명량	*명량/NNP
명령	*명령/NNG
명료	*명료/NNG
명멸	*명멸/NNG
명명	*명명/NNG
명목	*명목/NNG
명부	*명부/NNG
명사	*명사/NNG
명상	*명상/NNG
명세	*명세/NNG
명소	*명소/NNG
명시	*명시/NNG
명실	*명실/NNG
명심	*명심/NNG
명암	*명암/NNG
명언	*명언/NNG
명정	*명정/NNG
명제	*명제/NNG
명종	*명종/NNP
명중	*명중/NNG
명증	*명증/NNG
명지	*명지/NNG
명징	*명징/NNG
명찰	*명찰/NNG
명창	*명창/NNG
명치	*명치/NNG
명퇴	*명퇴/NNG
명패	*명패/NNG
모각	*모각/NNG
모계	*모계/NNG
모년	*모년/NNG
모대	*모대/NNG
모독	*모독/NNG
모란	*모란/NNG
모략	*모략/NNG
모량	*모량/NNG
모리	*모리/NNP
모면	*모면/NNG
모멸	*모멸/NNG
모반	*모반/NNG
모방	*모방/NNG
모범	*모범/NNG
모법	*모법/NNG
모병	*모병/NNG
모본	*모본/NNG
모사	*모사/NNG
모살	*모살/NNG
모색	*모색/NNG
모성	*모성/NNG
모순	*모순/NNG
모습	*모습/NNG
모역	*모역/NNG
모욕	*모욕/NNG
모우	*모우/NNP
모의	*모의/NNG
모작	*모작/NNG
모조	*모조/NNG
모종	*모종/NNG
모주	*모주/NNG
모질	*모질/VA
모집	*모집/NNG
모칭	*모칭/NNG
모탈	*모탈/NNG
모피	*모피/NNG
모함	*모함/NNG
모해	*모해/NNG
모험	*모험/NNG
모화	*모화/NNG
목각	*목각/NNG
목격	*목격/NNG
목견	*목견/NNG
목단	*목단/NNG
목도	*목도/NNG
목례	*목례/NNG
목로	*목로/NNG
목마	*목마/NNG
목물	*목물/NNG
목민	*목민/NNG
목발	*목발/NNG
목산	*목산/NNG
목수	*목수/NNG
목양	*목양/NNG
목어	*목어/NNG
목욕	*목욕/NNG
목우	*목우/NNG
목적	*목적/NNG
목제	*목제/NNG
목조	*목조/NNG
목축	*목축/NNG
목측	*목측/NNG
목표	*목표/NNG
목화	*목화/NNG
목회	*목회/NNG
몬탁	*몬탁/NNP
몰각	*몰각/NNG
몰두	*몰두/NNG
몰락	*몰락/NNG
몰방	*몰방/NNG
몰사	*몰사/NNG
몰살	*몰살/NNG
몰수	*몰수/NNG
몰입	*몰입/NNG
몰패	*몰패/NNG
몰풍	*몰풍/NNG
몸짓	*몸짓/NNG
몽고	*몽고/NNP
몽글	*몽글/VA
몽땅	*몽땅/MAG
몽리	*몽리/NNG
몽매	*몽매/NNG
몽상	*몽상/NNG
몽양	*몽양/NNP
몽유	*몽유/NNG
몽정	*몽정/NNG
몽진	*몽진/NNG
몽탕	*몽탕/NNP
몽톡	*몽톡/MAG
몽혼	*몽혼/NNG
묘계	*묘계/NNG
묘기	*묘기/NNG
묘막	*묘막/NNG
묘망	*묘망/NNG
묘사	*묘사/NNG
묘선	*묘선/NNP
묘소	*묘소/NNG
묘원	*묘원/NNG
묘절	*묘절/NNG
묘출	*묘출/NNG
묘파	*묘파/NNG
묘호	*묘호/NNG
묘화	*묘화/NNG
무가	*무가/NNG
무간	*무간/NNG
무감	*무감/NNG
무강	*무강/VA
무개	*무개/NNG
무겁	*무겁/VA
무고	*무고/NNG
무곡	*무곡/NNG
무공	*무공/NNG
무관	*무관/NNG
무구	*무구/NNG
무궁	*무궁/NNG
무극	*무극/NNG
무기	*무기/NNG
무념	*무념/NNG
무능	*무능/NNG
무단	*무단/NNG
무덕	*무덕/NNG
무독	*무독/NNG
무등	*무등/NNG
무량	*무량/NNG
무려	*무려/MAG
무력	*무력/NNG
무렴	*무렴/NNG
무례	*무례/NNG
무료	*무료/NNG
무류	*무류/NNG
무리	*무리/NNG
무림	*무림/NNG
무마	*무마/NNG
무명	*무명/NNG
무모	*무모/NNG
무문	*무문/NNG
무미	*무미/NNG
무법	*무법/NNG
무변	*무변/NNG
무병	*무병/NNG
무보	*무보/NNG
무복	*무복/NNG
무빙	*무빙/NNG
무사	*무사/NNG
무산	*무산/NNG
무상	*무상/NNG
무색	*무색/NNG
무생	*무생/NNG
무성	*무성/NNG
무세	*무세/NNG
무소	*무소/NNG
무수	*무수/NNG
무시	*무시/NNG
무식	*무식/NNG
무실	*무실/NNG
무심	*무심/NNG
무애	*무애/NNG
무언	*무언/NNG
무엇	*무엇/NP
무역	*무역/NNG
무연	*무연/NNG
무열	*무열/NNG
무예	*무예/NNG
무왕	*무왕/NNP
무욕	*무욕/NNG
무용	*무용/NNG
무위	*무위/NNG
무의	*무의/NNG
무인	*무인/NNG
무자	*무자/NNG
무작	*무작/NNG
무장	*무장/NNG
무재	*무재/NNG
무적	*무적/NNG
무전	*무전/NNG
무조	*무조/NNG
무죄	*무죄/NNG
무주	*무주/NNP
무직	*무직/NNG
무참	*무참/NNG
무책	*무책/NNG
무척	*무척/MAG
무천	*무천/NNG
무초	*무초/NNP
무취	*무취/NNG
무치	*무치/VV
무한	*무한/NNG
무형	*무형/NNG
무효	*무효/NNG
무후	*무후/NNG
무휴	*무휴/NNG
묵계	*묵계/NNG
묵과	*묵과/NNG
묵념	*묵념/NNG
묵도	*묵도/NNG
묵독	*묵독/NNG
묵례	*묵례/NNG
묵비	*묵비/NNG
묵살	*묵살/NNG
묵상	*묵상/NNG
묵서	*묵서/NNG
묵수	*묵수/NNG
묵시	*묵시/NNG
묵언	*묵언/NNG
묵음	*묵음/NNG
묵인	*묵인/NNG
묵적	*묵적/NNP
묵허	*묵허/NNG
문경	*문경/NNP
문계	*문계/NNG
문과	*문과/NNG
문교	*문교/NNG
문구	*문구/NNG
문답	*문답/NNG
문덕	*문덕/NNG
문득	*문득/MAG
문란	*문란/NNG
문망	*문망/NNG
문미	*문미/NNG
문법	*문법/NNG
문병	*문병/NNG
문부	*문부/NNG
문사	*문사/NNG
문상	*문상/NNG
문선	*문선/NNG
문수	*문수/NNP
문식	*문식/NNG
문신	*문신/NNG
문안	*문안/NNG
문약	*문약/NNG
문의	*문의/NNG
문자	*문자/NNG
문적	*문적/NNG
문정	*문정/NNG
문조	*문조/NNG
문죄	*문죄/NNG
문지	*문지/NNG
문진	*문진/NNG
문책	*문책/NNG
문초	*문초/NNG
문치	*문치/NNG
문턱	*문턱/NNG
문학	*문학/NNG
문향	*문향/NNG
문후	*문후/NNG
물림	*물림/NNG
물색	*물색/NNG
물소	*물소/NNG
물시	*물시/NNG
물씬	*물씬/MAG
물질	*물질/NNG
물컥	*물컥/MAG
물큰	*물큰/MAG
물화	*물화/NNG
뭉글	*뭉글/VV
뭉뚝	*뭉뚝/MAG
뭉실	*뭉실/MAG
뭉클	*뭉클/MAG
뭉텅	*뭉텅/MAG
뭉툭	*뭉툭/MAG
미감	*미감/NNG
미개	*미개/NNG
미결	*미결/NNG
미구	*미구/NNG
미급	*미급/NNG
미기	*미기/NNG
미납	*미납/NNG
미달	*미달/NNG
미담	*미담/NNG
미답	*미답/NNG
미대	*미대/NNG
미도	*미도/NNP
미동	*미동/NNG
미두	*미두/NNG
미등	*미등/NNG
미란	*미란/NNP
미량	*미량/NNG
미력	*미력/NNG
미련	*미련/NNG
미령	*미령/NNP
미료	*미료/NNG
미만	*미만/NNG
미망	*미망/NNG
미면	*미면/NNG
미명	*미명/NNG
미문	*미문/NNG
미미	*미미/NNP
미발	*미발/NNG
미백	*미백/NNG
미복	*미복/NNG
미봉	*미봉/NNG
미부	*미부/NNG
미분	*미분/NNG
미불	*미불/NNG
미비	*미비/NNG
미상	*미상/NNG
미색	*미색/NNG
미성	*미성/NNG
미세	*미세/NNG
미소	*미소/NNG
미수	*미수/NNG
미시	*미시/NNG
미식	*미식/NNG
미신	*미신/NNG
미실	*미실/NNG
미심	*미심/NNG
미안	*미안/NNG
미역	*미역/NNG
미열	*미열/NNG
미온	*미온/NNG
미완	*미완/NNG
미왕	*미왕/NNP
미용	*미용/NNG
미음	*미음/NNG
미장	*미장/NNG
미정	*미정/NNG
미주	*미주/NNG
미증	*미증/NNG
미지	*미지/NNG
미첨	*미첨/NNP
미타	*미타/NNP
미필	*미필/NNG
미행	*미행/NNG
미혹	*미혹/NNG
미화	*미화/NNG
미흡	*미흡/NNG
민감	*민감/NNG
민란	*민란/NNG
민련	*민련/NNG
민립	*민립/NNG
민박	*민박/NNG
민속	*민속/NNG
민예	*민예/NNG
민완	*민완/NNG
민요	*민요/NNG
밀담	*밀담/NNG
밀도	*밀도/NNG
밀렵	*밀렵/NNG
밀매	*밀매/NNG
밀명	*밀명/NNG
밀모	*밀모/NNG
밀물	*밀물/NNG
밀봉	*밀봉/NNG
밀사	*밀사/NNG
밀생	*밀생/NNG
밀수	*밀수/NNG
밀식	*밀식/NNG
밀애	*밀애/NNG
밀약	*밀약/NNG
밀영	*밀영/NNG
밀의	*밀의/NNG
밀접	*밀접/NNG
밀정	*밀정/NNG
밀조	*밀조/NNG
밀주	*밀주/NNG
밀집	*밀집/NNG
밀착	*밀착/NNG
밀초	*밀초/NNG
밀치	*밀치/VV
밀통	*밀통/NNG
밀파	*밀파/NNG
밀폐	*밀폐/NNG
밀항	*밀항/NNG
밀행	*밀행/NNG
밀화	*밀화/NNG
밀회	*밀회/NNG
바삭	*바삭/MAG
바심	*바심/NNG
바싹	*바싹/MAG
바작	*바작/NNG
바터	*바터/NNG
박대	*박대/NNG
박덕	*박덕/NNG
박동	*박동/NNG
박두	*박두/NNG
박리	*박리/NNG
박멸	*박멸/NNG
박명	*박명/NNG
박문	*박문/NNG
박미	*박미/NNP
박박	*박박/MAG
박복	*박복/NNG
박살	*박살/NNG
박수	*박수/NNG
박순	*박순/NNP
박식	*박식/NNG
박애	*박애/NNG
박약	*박약/NNG
박장	*박장/NNG
박전	*박전/NNP
박제	*박제/NNG
박탈	*박탈/NNG
박토	*박토/NNG
박피	*박피/NNG
박학	*박학/NNG
박해	*박해/NNG
박행	*박행/NNG
반가	*반가/NNG
반감	*반감/NNG
반격	*반격/NNG
반고	*반고/NNP
반곡	*반곡/NNG
반공	*반공/NNG
반구	*반구/NNG
반군	*반군/NNG
반납	*반납/NNG
반당	*반당/NNG
반대	*반대/NNG
반도	*반도/NNG
반동	*반동/NNG
반둥	*반둥/NNP
반등	*반등/NNG
반뜩	*반뜩/MAG
반락	*반락/NNG
반란	*반란/NNG
반려	*반려/NNG
반례	*반례/NNG
반론	*반론/NNG
반말	*반말/NNG
반면	*반면/NNG
반명	*반명/NNG
반목	*반목/NNG
반문	*반문/NNG
반박	*반박/NNG
반반	*반반/NNG
반발	*반발/NNG
반복	*반복/NNG
반분	*반분/NNG
반빙	*반빙/NNG
반사	*반사/NNG
반상	*반상/NNG
반색	*반색/NNG
반성	*반성/NNG
반수	*반수/NNG
반숙	*반숙/NNG
반시	*반시/NNG
반신	*반신/NNG
반실	*반실/NNG
반역	*반역/NNG
반연	*반연/NNG
반영	*반영/NNG
반우	*반우/NNG
반원	*반원/NNG
반응	*반응/NNG
반의	*반의/NNG
반입	*반입/NNG
반장	*반장/NNG
반전	*반전/NNG
반절	*반절/NNG
반점	*반점/NNG
반정	*반정/NNG
반제	*반제/NNG
반조	*반조/NNG
반주	*반주/NNG
반죽	*반죽/NNG
반증	*반증/NNG
반짝	*반짝/MAG
반추	*반추/NNG
반출	*반출/NNG
반취	*반취/NNG
반칙	*반칙/NNG
반탁	*반탁/NNG
반파	*반파/NNG
반포	*반포/NNG
반품	*반품/NNG
반함	*반함/NNG
반항	*반항/NNG
반행	*반행/NNG
반호	*반호/NNG
반혼	*반혼/NNG
반환	*반환/NNG
받자	*받자/NNG
발각	*발각/NNG
발간	*발간/NNG
발견	*발견/NNG
발고	*발고/NNG
발광	*발광/NNG
발군	*발군/NNG
발굴	*발굴/NNG
발권	*발권/NNG
발금	*발금/NNG
발급	*발급/NNG
발깍	*발깍/MAG
발끈	*발끈/MAG
발단	*발단/NNG
발달	*발달/NNG
발동	*발동/NNG
발딱	*발딱/MAG
발랑	*발랑/MAG
발령	*발령/NNG
발론	*발론/NNG
발롱	*발롱/NNP
발마	*발마/NNP
발매	*발매/NNG
발명	*발명/NNG
발모	*발모/NNG
발몽	*발몽/NNG
발묵	*발묵/NNG
발문	*발문/NNG
발병	*발병/NNG
발복	*발복/NNG
발본	*발본/NNG
발부	*발부/NNG
발분	*발분/NNG
발뺌	*발뺌/NNG
발사	*발사/NNG
발산	*발산/NNG
발상	*발상/NNG
발생	*발생/NNG
발선	*발선/NNG
발설	*발설/NNG
발섭	*발섭/NNG
발성	*발성/NNG
발송	*발송/NNG
발신	*발신/NNG
발심	*발심/NNG
발아	*발아/NNG
발악	*발악/NNG
발안	*발안/NNP
발암	*발암/NNG
발양	*발양/NNG
발언	*발언/NNG
발열	*발열/NNG
발원	*발원/NNG
발육	*발육/NNG
발음	*발음/NNG
발의	*발의/NNG
발인	*발인/NNG
발작	*발작/NNG
발전	*발전/NNG
발정	*발정/NNG
발제	*발제/NNG
발족	*발족/NNG
발주	*발주/NNG
발진	*발진/NNG
발짓	*발짓/NNG
발짝	*발짝/NNB
발차	*발차/NNG
발착	*발착/NNG
발천	*발천/NNG
발출	*발출/NNG
발췌	*발췌/NNG
발치	*발치/NNG
발칵	*발칵/MAG
발탁	*발탁/NNG
발통	*발통/NNG
발파	*발파/NNG
발판	*발판/NNG
발포	*발포/NNG
발표	*발표/NNG
발한	*발한/NNG
발해	*발해/NNP
발행	*발행/NNG
발현	*발현/NNG
발호	*발호/NNG
발화	*발화/NNG
발효	*발효/NNG
발휘	*발휘/NNG
발흥	*발흥/NNG
밤샘	*밤샘/NNG
밤일	*밤일/NNG
방가	*방가/NNG
방각	*방각/NNG
방계	*방계/NNG
방공	*방공/NNG
방과	*방과/NNG
방관	*방관/NNG
방광	*방광/NNG
방구	*방구/NNG
방긋	*방긋/MAG
방기	*방기/NNG
방납	*방납/NNG
방뇨	*방뇨/NNG
방단	*방단/NNG
방담	*방담/NNG
방도	*방도/NNG
방독	*방독/NNG
방랑	*방랑/NNG
방략	*방략/NNG
방량	*방량/NNG
방류	*방류/NNG
방매	*방매/NNG
방면	*방면/NNG
방명	*방명/NNG
방모	*방모/NNG
방목	*방목/NNG
방문	*방문/NNG
방벌	*방벌/NNG
방범	*방범/NNG
방벽	*방벽/NNG
방부	*방부/NNG
방북	*방북/NNG
방비	*방비/NNG
방사	*방사/NNG
방산	*방산/NNG
방색	*방색/NNG
방생	*방생/NNG
방석	*방석/NNG
방선	*방선/NNG
방소	*방소/NNG
방송	*방송/NNG
방수	*방수/NNG
방습	*방습/NNG
방시	*방시/NNG
방식	*방식/NNG
방심	*방심/NNG
방싯	*방싯/MAG
방애	*방애/NNG
방어	*방어/NNG
방언	*방언/NNG
방역	*방역/NNG
방연	*방연/NNP
방열	*방열/NNG
방염	*방염/NNG
방영	*방영/NNG
방위	*방위/NNG
방유	*방유/NNG
방음	*방음/NNG
방임	*방임/NNG
방장	*방장/NNG
방재	*방재/NNG
방적	*방적/NNG
방전	*방전/NNG
방정	*방정/NNG
방제	*방제/NNG
방조	*방조/NNG
방종	*방종/NNG
방주	*방주/NNG
방증	*방증/NNG
방지	*방지/NNG
방직	*방직/NNG
방진	*방진/NNG
방차	*방차/NNG
방첩	*방첩/NNG
방청	*방청/NNG
방추	*방추/NNG
방축	*방축/NNG
방출	*방출/NNG
방충	*방충/NNG
방취	*방취/NNG
방치	*방치/NNG
방탄	*방탄/NNG
방탕	*방탕/NNG
방포	*방포/NNG
방풍	*방풍/NNG
방학	*방학/NNG
방한	*방한/NNG
방해	*방해/NNG
방행	*방행/NNG
방호	*방호/NNG
방화	*방화/NNG
방황	*방황/NNG
밭일	*밭일/NNG
배강	*배강/NNG
배격	*배격/NNG
배견	*배견/NNG
배경	*배경/NNG
배관	*배관/NNG
배교	*배교/NNG
배구	*배구/NNG
배금	*배금/NNG
배급	*배급/NNG
배뇨	*배뇨/NNG
배달	*배달/NNG
배당	*배당/NNG
배덕	*배덕/NNG
배란	*배란/NNG
배려	*배려/NNG
배례	*배례/NNG
배리	*배리/NNP
배릿	*배릿/NNP
배면	*배면/NNG
배명	*배명/NNP
배미	*배미/NNG
배반	*배반/NNG
배변	*배변/NNG
배부	*배부/NNG
배분	*배분/NNG
배불	*배불/NNG
배상	*배상/NNG
배색	*배색/NNG
배서	*배서/NNG
배석	*배석/NNG
배선	*배선/NNG
배설	*배설/NNG
배소	*배소/NNG
배송	*배송/NNG
배수	*배수/NNG
배시	*배시/NNP
배식	*배식/NNG
배신	*배신/NNG
배알	*배알/NNG
배약	*배약/NNG
배양	*배양/NNG
배역	*배역/NNG
배연	*배연/NNG
배열	*배열/NNG
배외	*배외/NNG
배웅	*배웅/NNG
배은	*배은/NNG
배임	*배임/NNG
배자	*배자/NNG
배작	*배작/NNG
배재	*배재/NNP
배전	*배전/NNG
배점	*배점/NNG
배정	*배정/NNG
배제	*배제/NNG
배종	*배종/NNG
배중	*배중/NNG
배증	*배증/NNG
배지	*배지/NNG
배질	*배질/NNG
배차	*배차/NNG
배척	*배척/NNG
배천	*배천/NNG
배추	*배추/NNG
배출	*배출/NNG
배치	*배치/NNG
배타	*배타/NNG
배태	*배태/NNG
배틀	*배틀/NNG
배포	*배포/NNG
배표	*배표/NNG
배합	*배합/NNG
배행	*배행/NNG
배향	*배향/NNG
배화	*배화/NNG
배회	*배회/NNG
배후	*배후/NNG
백문	*백문/NNG
백방	*백방/NNG
백배	*백배/NNG
백산	*백산/NNP
백상	*백상/NNP
백석	*백석/NNP
백숙	*백숙/NNG
백업	*백업/NNG
백열	*백열/NNG
백작	*백작/NNG
백출	*백출/NNG
백파	*백파/NNP
뱃일	*뱃일/NNG
뱅글	*뱅글/MAG
뱅뱅	*뱅뱅/MAG
뱅킹	*뱅킹/NNG
버금	*버금/NNG
버긋	*버긋/NNG
버들	*버들/NNG
버럭	*버럭/MAG
버썩	*버썩/MAG
벅벅	*벅벅/MAG
번뇌	*번뇌/NNG
번둥	*번둥/NNG
번들	*번들/NNG
번듯	*번듯/MAG
번뜩	*번뜩/MAG
번뜻	*번뜻/MAG
번롱	*번롱/NNG
번문	*번문/NNG
번민	*번민/NNG
번복	*번복/NNG
번성	*번성/NNG
번시	*번시/NNP
번식	*번식/NNG
번신	*번신/NNP
번안	*번안/NNG
번역	*번역/NNG
번연	*번연/NNP
번영	*번영/NNG
번의	*번의/NNG
번잡	*번잡/NNG
번적	*번적/MAG
번제	*번제/NNG
번족	*번족/NNG
번쩍	*번쩍/MAG
번창	*번창/NNG
번트	*번트/NNG
번하	*번하/VA
번화	*번화/NNG
벌떡	*벌떡/MAG
벌렁	*벌렁/MAG
벌목	*벌목/NNG
벌벌	*벌벌/MAG
벌열	*벌열/NNG
벌쭉	*벌쭉/MAG
벌채	*벌채/NNG
벌초	*벌초/NNG
벌충	*벌충/NNG
벌컥	*벌컥/MAG
범간	*범간/NNG
범경	*범경/NNG
범람	*범람/NNG
범발	*범발/NNG
범방	*범방/NNG
범법	*범법/NNG
범상	*범상/NNG
범색	*범색/NNG
범속	*범속/NNG
범수	*범수/NNP
범역	*범역/NNG
범용	*범용/NNG
범일	*범일/NNP
범접	*범접/NNG
범종	*범종/NNG
범주	*범주/NNG
범칙	*범칙/NNG
범퇴	*범퇴/NNG
범포	*범포/NNP
범행	*범행/NNG
법문	*법문/NNG
법석	*법석/NNG
법전	*법전/NNG
법제	*법제/NNG
법치	*법치/NNG
법화	*법화/NNG
벙긋	*벙긋/MAG
벙싯	*벙싯/MAG
벼슬	*벼슬/NNG
벽곡	*벽곡/NNG
벽사	*벽사/NNG
벽용	*벽용/NNG
벽재	*벽재/NNG
벽제	*벽제/NNP
벽파	*벽파/NNG
변개	*변개/NNG
변경	*변경/NNG
변고	*변고/NNG
변급	*변급/NNP
변동	*변동/NNG
변론	*변론/NNG
변리	*변리/NNG
변매	*변매/NNG
변명	*변명/NNG
변모	*변모/NNG
변발	*변발/NNG
변법	*변법/NNG
변별	*변별/NNG
변복	*변복/NNG
변비	*변비/NNG
변사	*변사/NNG
변상	*변상/NNG
변색	*변색/NNG
변설	*변설/NNG
변성	*변성/NNG
변속	*변속/NNG
변수	*변수/NNG
변신	*변신/NNG
변심	*변심/NNG
변역	*변역/NNG
변온	*변온/NNG
변용	*변용/NNG
변이	*변이/NNG
변작	*변작/NNG
변장	*변장/NNG
변전	*변전/NNG
변절	*변절/NNG
변제	*변제/NNG
변조	*변조/NNG
변종	*변종/NNG
변주	*변주/NNG
변증	*변증/NNG
변질	*변질/NNG
변천	*변천/NNG
변체	*변체/NNG
변칙	*변칙/NNG
변침	*변침/NNG
변태	*변태/NNG
변통	*변통/NNG
변패	*변패/NNG
변하	*변하/VV
변혁	*변혁/NNG
변형	*변형/NNG
변호	*변호/NNG
변화	*변화/NNG
변환	*변환/NNG
별게	*별게/NNG
별견	*별견/NNG
별관	*별관/NNG
별급	*별급/NNG
별납	*별납/NNG
별론	*별론/NNG
별리	*별리/NNG
별무	*별무/NNG
별세	*별세/NNG
별이	*별이/NNP
별정	*별정/NNG
병간	*병간/NNG
병거	*병거/NNG
병과	*병과/NNG
병구	*병구/NNG
병권	*병권/NNG
병기	*병기/NNG
병력	*병력/NNG
병렬	*병렬/NNG
병리	*병리/NNG
병립	*병립/NNG
병문	*병문/NNG
병발	*병발/NNG
병사	*병사/NNG
병살	*병살/NNG
병생	*병생/NNG
병서	*병서/NNG
병설	*병설/NNG
병수	*병수/NNP
병식	*병식/NNG
병어	*병어/NNG
병영	*병영/NNG
병요	*병요/NNG
병용	*병용/NNG
병작	*병작/NNG
병장	*병장/NNG
병적	*병적/NNG
병전	*병전/NNG
병점	*병점/NNP
병존	*병존/NNG
병졸	*병졸/NNG
병진	*병진/NNG
병창	*병창/NNG
병치	*병치/NNG
병칭	*병칭/NNG
병탄	*병탄/NNG
병탈	*병탈/NNG
병폐	*병폐/NNG
병합	*병합/NNG
병행	*병행/NNG
보강	*보강/NNG
보결	*보결/NNG
보공	*보공/NNG
보관	*보관/NNG
보국	*보국/NNG
보궐	*보궐/NNG
보균	*보균/NNG
보급	*보급/NNG
보답	*보답/NNG
보도	*보도/NNG
보동	*보동/NNG
보람	*보람/NNG
보류	*보류/NNG
보륜	*보륜/NNG
보명	*보명/NNG
보민	*보민/NNG
보복	*보복/NNG
보본	*보본/NNG
보비	*보비/NNP
보빙	*보빙/NNG
보사	*보사/NNG
보살	*보살/NNG
보상	*보상/NNG
보석	*보석/NNG
보선	*보선/NNG
보성	*보성/NNP
보속	*보속/NNG
보수	*보수/NNG
보습	*보습/NNG
보신	*보신/NNG
보쌈	*보쌈/NNG
보안	*보안/NNG
보양	*보양/NNG
보온	*보온/NNG
보완	*보완/NNG
보용	*보용/NNG
보우	*보우/NNG
보위	*보위/NNG
보유	*보유/NNG
보육	*보육/NNG
보은	*보은/NNP
보음	*보음/NNG
보익	*보익/NNG
보인	*보인/NNG
보장	*보장/NNG
보전	*보전/NNG
보정	*보정/NNG
보조	*보조/NNG
보족	*보족/NNG
보존	*보존/NNG
보종	*보종/NNG
보좌	*보좌/NNG
보주	*보주/NNG
보증	*보증/NNG
보직	*보직/NNG
보채	*보채/VV
보천	*보천/NNP
보철	*보철/NNG
보첨	*보첨/NNG
보총	*보총/NNG
보축	*보축/NNG
보충	*보충/NNG
보태	*보태/VV
보토	*보토/NNG
보편	*보편/NNG
보필	*보필/NNG
보합	*보합/NNG
보해	*보해/NNP
보행	*보행/NNG
보혈	*보혈/NNG
보호	*보호/NNG
보훈	*보훈/NNG
복각	*복각/NNG
복간	*복간/NNG
복개	*복개/NNG
복검	*복검/NNG
복고	*복고/NNG
복교	*복교/NNG
복구	*복구/NNG
복권	*복권/NNG
복귀	*복귀/NNG
복근	*복근/NNG
복기	*복기/NNG
복당	*복당/NNG
복대	*복대/NNG
복도	*복도/NNG
복락	*복락/NNG
복례	*복례/NNG
복류	*복류/NNG
복면	*복면/NNG
복명	*복명/NNG
복무	*복무/NNG
복발	*복발/NNG
복벽	*복벽/NNG
복병	*복병/NNG
복분	*복분/NNG
복비	*복비/NNG
복사	*복사/NNG
복상	*복상/NNG
복서	*복서/NNG
복선	*복선/NNG
복성	*복성/NNG
복속	*복속/NNG
복송	*복송/NNG
복수	*복수/NNG
복습	*복습/NNG
복시	*복시/NNG
복식	*복식/NNG
복신	*복신/NNP
복심	*복심/NNG
복안	*복안/NNG
복약	*복약/NNG
복역	*복역/NNG
복용	*복용/NNG
복운	*복운/NNG
복원	*복원/NNG
복위	*복위/NNG
복의	*복의/NNG
복일	*복일/NNG
복자	*복자/NNG
복장	*복장/NNG
복적	*복적/NNG
복점	*복점/NNG
복정	*복정/NNP
복제	*복제/NNG
복조	*복조/NNG
복종	*복종/NNG
복주	*복주/NNG
복직	*복직/NNG
복창	*복창/NNG
복청	*복청/NNG
복초	*복초/NNG
복토	*복토/NNG
복통	*복통/NNG
복학	*복학/NNG
복합	*복합/NNG
복호	*복호/NNG
본봉	*본봉/NNG
본연	*본연/NNG
본유	*본유/NNG
볼록	*볼록/MAG
볼쏙	*볼쏙/MAG
봉게	*봉게/NNG
봉고	*봉고/NNG
봉공	*봉공/NNG
봉긋	*봉긋/MAG
봉기	*봉기/NNG
봉납	*봉납/NNG
봉대	*봉대/NNP
봉독	*봉독/NNG
봉로	*봉로/NNG
봉명	*봉명/NNG
봉미	*봉미/NNG
봉반	*봉반/NNG
봉변	*봉변/NNG
봉분	*봉분/NNG
봉비	*봉비/NNG
봉사	*봉사/NNG
봉삭	*봉삭/NNG
봉서	*봉서/NNG
봉소	*봉소/NNG
봉송	*봉송/NNG
봉쇄	*봉쇄/NNG
봉수	*봉수/NNP
봉식	*봉식/NNP
봉신	*봉신/NNG
봉심	*봉심/NNG
봉안	*봉안/NNG
봉양	*봉양/NNG
봉영	*봉영/NNG
봉욕	*봉욕/NNG
봉인	*봉인/NNG
봉작	*봉작/NNG
봉장	*봉장/NNG
봉적	*봉적/NNG
봉점	*봉점/NNG
봉정	*봉정/NNG
봉제	*봉제/NNG
봉준	*봉준/NNP
봉지	*봉지/NNG
봉직	*봉직/NNG
봉진	*봉진/NNG
봉착	*봉착/NNG
봉창	*봉창/NNG
봉축	*봉축/NNG
봉출	*봉출/NNG
봉치	*봉치/NNG
봉칙	*봉칙/NNG
봉토	*봉토/NNG
봉패	*봉패/NNG
봉함	*봉함/NNG
봉합	*봉합/NNG
봉행	*봉행/NNG
봉향	*봉향/NNG
봉헌	*봉헌/NNG
봉화	*봉화/NNG
봉환	*봉환/NNG
부각	*부각/NNG
부감	*부감/NNG
부검	*부검/NNG
부결	*부결/NNG
부고	*부고/NNG
부곡	*부곡/NNG
부과	*부과/NNG
부관	*부관/NNG
부구	*부구/NNP
부귀	*부귀/NNG
부기	*부기/NNG
부담	*부담/NNG
부답	*부답/NNG
부당	*부당/NNG
부덕	*부덕/NNG
부동	*부동/NNG
부득	*부득/MAG
부들	*부들/NNG
부란	*부란/NNG
부랑	*부랑/NNG
부록	*부록/NNG
부론	*부론/NNP
부류	*부류/NNG
부릉	*부릉/MAG
부마	*부마/NNG
부묘	*부묘/NNG
부문	*부문/NNG
부별	*부별/NNG
부복	*부복/NNG
부부	*부부/NNG
부분	*부분/NNG
부빙	*부빙/NNG
부사	*부사/NNG
부산	*부산/NNP
부삽	*부삽/NNG
부상	*부상/NNG
부생	*부생/NNG
부서	*부서/NNG
부설	*부설/NNG
부성	*부성/NNG
부세	*부세/NNG
부소	*부소/NNP
부속	*부속/NNG
부숙	*부숙/NNG
부식	*부식/NNG
부신	*부신/NNG
부실	*부실/NNG
부심	*부심/NNG
부액	*부액/NNG
부양	*부양/NNG
부언	*부언/NNG
부역	*부역/NNG
부연	*부연/NNG
부영	*부영/NNP
부와	*부와/NNG
부우	*부우/NNG
부원	*부원/NNG
부위	*부위/NNG
부유	*부유/NNG
부윤	*부윤/NNG
부음	*부음/NNG
부응	*부응/NNG
부의	*부의/NNG
부이	*부이/NNG
부인	*부인/NNG
부임	*부임/NNG
부장	*부장/NNG
부재	*부재/NNG
부적	*부적/NNG
부전	*부전/NNG
부절	*부절/NNG
부접	*부접/NNG
부정	*부정/NNG
부제	*부제/NNG
부조	*부조/NNG
부족	*부족/NNG
부존	*부존/NNG
부종	*부종/NNG
부주	*부주/NNG
부중	*부중/NNG
부지	*부지/NNG
부진	*부진/NNG
부집	*부집/NNG
부쩍	*부쩍/MAG
부착	*부착/NNG
부찰	*부찰/NNG
부채	*부채/NNG
부책	*부책/NNG
부천	*부천/NNP
부청	*부청/NNG
부초	*부초/NNG
부축	*부축/NNG
부침	*부침/NNG
부탁	*부탁/NNG
부토	*부토/NNG
부파	*부파/NNG
부판	*부판/NNG
부패	*부패/NNG
부표	*부표/NNG
부합	*부합/NNG
부형	*부형/NNG
부호	*부호/NNG
부화	*부화/NNG
부활	*부활/NNG
부황	*부황/NNG
부회	*부회/NNG
부흥	*부흥/NNG
북면	*북면/NNP
북벌	*북벌/NNG
북북	*북북/MAG
북상	*북상/NNG
북송	*북송/NNG
북적	*북적/MAG
북정	*북정/NNG
북진	*북진/NNG
북침	*북침/NNG
북행	*북행/NNG
북향	*북향/NNG
분가	*분가/NNG
분간	*분간/NNG
분개	*분개/NNG
분거	*분거/NNG
분격	*분격/NNG
분결	*분결/NNG
분고	*분고/NNP
분공	*분공/NNG
분과	*분과/NNG
분관	*분관/NNG
분광	*분광/NNG
분구	*분구/NNG
분권	*분권/NNG
분급	*분급/NNG
분기	*분기/NNG
분깃	*분깃/NNG
분납	*분납/NNG
분노	*분노/NNG
분뇨	*분뇨/NNG
분단	*분단/NNG
분담	*분담/NNG
분당	*분당/NNP
분대	*분대/NNG
분동	*분동/NNG
분란	*분란/NNG
분류	*분류/NNG
분리	*분리/NNG
분립	*분립/NNG
분만	*분만/NNG
분말	*분말/NNG
분무	*분무/NNG
분발	*분발/NNG
분방	*분방/NNG
분배	*분배/NNG
분변	*분변/NNG
분별	*분별/NNG
분복	*분복/NNG
분봉	*분봉/NNG
분부	*분부/NNG
분비	*분비/NNG
분사	*분사/NNG
분산	*분산/NNG
분상	*분상/NNG
분석	*분석/NNG
분소	*분소/NNG
분속	*분속/NNG
분쇄	*분쇄/NNG
분수	*분수/NNG
분승	*분승/NNG
분식	*분식/NNG
분신	*분신/NNG
분실	*분실/NNG
분양	*분양/NNG
분업	*분업/NNG
분여	*분여/NNG
분열	*분열/NNG
분요	*분요/NNG
분원	*분원/NNG
분위	*분위/NNG
분유	*분유/NNG
분임	*분임/NNG
분장	*분장/NNG
분재	*분재/NNG
분쟁	*분쟁/NNG
분전	*분전/NNG
분절	*분절/NNG
분주	*분주/NNG
분지	*분지/NNG
분진	*분진/NNG
분첩	*분첩/NNG
분출	*분출/NNG
분칠	*분칠/NNG
분탕	*분탕/NNG
분토	*분토/NNG
분투	*분투/NNG
분파	*분파/NNG
분판	*분판/NNG
분패	*분패/NNG
분포	*분포/NNG
분필	*분필/NNG
분하	*분하/VA
분한	*분한/NNG
분할	*분할/NNG
분합	*분합/NNG
분해	*분해/NNG
분향	*분향/NNG
분화	*분화/NNG
분획	*분획/NNG
불가	*불가/NNG
불각	*불각/NNG
불감	*불감/NNG
불거	*불거/NNG
불결	*불결/NNG
불경	*불경/NNG
불계	*불계/NNG
불공	*불공/NNG
불과	*불과/MAG
불구	*불구/NNG
불굴	*불굴/NNG
불궤	*불궤/NNG
불귀	*불귀/NNG
불금	*불금/NNG
불급	*불급/NNG
불기	*불기/NNG
불길	*불길/NNG
불끈	*불끈/MAG
불낙	*불낙/NNG
불노	*불노/NNG
불능	*불능/NNG
불뚝	*불뚝/MAG
불란	*불란/NNG
불량	*불량/NNG
불령	*불령/NNG
불룩	*불룩/MAG
불륜	*불륜/NNG
불만	*불만/NNG
불망	*불망/NNG
불매	*불매/NNG
불면	*불면/NNG
불멸	*불멸/NNG
불명	*불명/NNG
불목	*불목/NNG
불무	*불무/NNG
불문	*불문/NNG
불미	*불미/NNG
불발	*불발/NNG
불방	*불방/NNG
불범	*불범/NNG
불법	*불법/NNG
불변	*불변/NNG
불복	*불복/NNG
불비	*불비/NNG
불사	*불사/NNG
불살	*불살/NNG
불상	*불상/NNG
불성	*불성/NNG
불소	*불소/NNG
불손	*불손/NNG
불순	*불순/NNG
불승	*불승/NNG
불식	*불식/NNG
불신	*불신/NNG
불심	*불심/NNG
불쑥	*불쑥/MAG
불안	*불안/NNG
불언	*불언/NNG
불역	*불역/NNG
불연	*불연/NNG
불온	*불온/NNG
불용	*불용/NNG
불우	*불우/NNG
불운	*불운/NNG
불원	*불원/NNG
불음	*불음/NNG
불응	*불응/NNG
불의	*불의/NNG
불인	*불인/NNG
불일	*불일/NNG
불임	*불임/NNG
불입	*불입/NNG
불참	*불참/NNG
불청	*불청/NNG
불초	*불초/NNG
불출	*불출/NNG
불충	*불충/NNG
불측	*불측/NNG
불치	*불치/NNG
불침	*불침/NNG
불통	*불통/NNG
불패	*불패/NNG
불편	*불편/NNG
불평	*불평/NNG
불하	*불하/NNG
불학	*불학/NNG
불행	*불행/NNG
불허	*불허/NNG
불혹	*불혹/NNG
불화	*불화/NNG
불황	*불황/NNG
불효	*불효/NNG
불후	*불후/NNG
붕괴	*붕괴/NNG
붕긋	*붕긋/MAG
붕락	*붕락/NNG
붕붕	*붕붕/MAG
붕어	*붕어/NNG
비각	*비각/NNG
비감	*비감/NNG
비강	*비강/NNG
비거	*비거/NNG
비견	*비견/NNG
비결	*비결/NNG
비경	*비경/NNG
비관	*비관/NNG
비교	*비교/NNG
비구	*비구/NNG
비굴	*비굴/NNG
비끗	*비끗/MAG
비난	*비난/NNG
비대	*비대/NNG
비도	*비도/NNG
비독	*비독/NNG
비동	*비동/NNG
비듬	*비듬/NNG
비등	*비등/NNG
비뚤	*비뚤/VA
비례	*비례/NNG
비루	*비루/NNG
비류	*비류/NNP
비만	*비만/NNG
비밀	*비밀/NNG
비방	*비방/NNG
비법	*비법/NNG
비보	*비보/NNG
비봉	*비봉/NNP
비부	*비부/NNG
비분	*비분/NNG
비사	*비사/NNG
비산	*비산/NNG
비상	*비상/NNG
비색	*비색/NNG
비서	*비서/NNG
비소	*비소/NNG
비속	*비속/NNG
비손	*비손/NNG
비수	*비수/NNG
비순	*비순/NNG
비슬	*비슬/NNP
비식	*비식/NNG
비심	*비심/NNG
비약	*비약/NNG
비역	*비역/NNG
비열	*비열/NNG
비옥	*비옥/NNG
비용	*비용/NNG
비우	*비우/VV
비원	*비원/NNG
비월	*비월/NNG
비유	*비유/NNG
비음	*비음/NNG
비의	*비의/NNG
비인	*비인/NNP
비자	*비자/NNG
비장	*비장/NNG
비적	*비적/NNG
비전	*비전/NNG
비절	*비절/NNG
비접	*비접/NNG
비정	*비정/NNG
비제	*비제/NNP
비조	*비조/NNG
비죽	*비죽/MAG
비준	*비준/NNG
비중	*비중/NNG
비진	*비진/NNG
비쭉	*비쭉/MAG
비차	*비차/NNG
비참	*비참/NNG
비창	*비창/NNP
비천	*비천/NNG
비축	*비축/NNG
비탄	*비탄/NNG
비탕	*비탕/NNG
비통	*비통/NNG
비판	*비판/NNG
비평	*비평/NNG
비품	*비품/NNG
비행	*비행/NNG
비호	*비호/NNG
비화	*비화/NNG
빈곤	*빈곤/NNG
빈공	*빈공/NNG
빈궁	*빈궁/NNG
빈도	*빈도/NNG
빈례	*빈례/NNG
빈말	*빈말/NNG
빈발	*빈발/NNG
빈소	*빈소/NNG
빈약	*빈약/NNG
빈전	*빈전/NNG
빈지	*빈지/NNG
빈천	*빈천/NNG
빈축	*빈축/NNG
빈출	*빈출/NNG
빈핍	*빈핍/NNG
빌미	*빌미/NNG
빌빌	*빌빌/MAG
빙거	*빙거/NNG
빙고	*빙고/NNG
빙글	*빙글/MAG
빙긋	*빙긋/MAG
빙빙	*빙빙/MAG
빙신	*빙신/NNG
빙의	*빙의/NNG
빙자	*빙자/NNG
빠각	*빠각/MAG
빠꼼	*빠꼼/MAG
빠꾸	*빠꾸/NNG
빠끔	*빠끔/MAG
빠삭	*빠삭/MAG
빠작	*빠작/MAG
빠직	*빠직/MAG
빡빡	*빡빡/MAG
빤짝	*빤짝/MAG
빨딱	*빨딱/MAG
빨랑	*빨랑/MAG
빨래	*빨래/NNG
빨빨	*빨빨/MAG
빨쪽	*빨쪽/MAG
빵끗	*빵끗/MAG
빵빵	*빵빵/MAG
빼곡	*빼곡/MAG
빼기	*빼기/NNG
빼꼭	*빼꼭/MAG
빼꼼	*빼꼼/MAG
빼쪽	*빼쪽/MAG
빼쭉	*빼쭉/MAG
빽빽	*빽빽/MAG
뺄셈	*뺄셈/NNG
뺑뺑	*뺑뺑/MAG
뻐끔	*뻐끔/MAG
뻔질	*뻔질/MAG
뻔쩍	*뻔쩍/MAG
뻘뻘	*뻘뻘/MAG
뻥긋	*뻥긋/MAG
뻥끗	*뻥끗/MAG
뻥뻥	*뻥뻥/MAG
뽀뽀	*뽀뽀/NNG
뽈록	*뽈록/MAG
뽕뽕	*뽕뽕/MAG
뾰족	*뾰족/MAG
뾰쪽	*뾰쪽/MAG
뿡뿡	*뿡뿡/MAG
삐걱	*삐걱/MAG
삐끗	*삐끗/MAG
삐딱	*삐딱/MAG
삐뚤	*삐뚤/VA
삐악	*삐악/MAG
삐죽	*삐죽/MAG
삐쭉	*삐쭉/MAG
삥땅	*삥땅/NNG
사간	*사간/NNG
사객	*사객/NNG
사거	*사거/NNG
사격	*사격/NNG
사견	*사견/NNG
사경	*사경/NNG
사계	*사계/NNG
사곡	*사곡/NNG
사과	*사과/NNG
사관	*사관/NNG
사광	*사광/NNG
사교	*사교/NNG
사구	*사구/NNG
사굴	*사굴/NNP
사규	*사규/NNG
사극	*사극/NNG
사냥	*사냥/NNG
사념	*사념/NNG
사단	*사단/NNG
사담	*사담/NNG
사대	*사대/NNG
사독	*사독/NNG
사돈	*사돈/NNG
사랑	*사랑/NNG
사략	*사략/NNG
사량	*사량/NNG
사려	*사려/NNG
사력	*사력/NNG
사련	*사련/NNG
사령	*사령/NNG
사례	*사례/NNG
사록	*사록/NNG
사료	*사료/NNG
사립	*사립/NNG
사막	*사막/NNG
사만	*사만/NR
사망	*사망/NNG
사매	*사매/NNG
사면	*사면/NNG
사멸	*사멸/NNG
사명	*사명/NNG
사모	*사모/NNG
사목	*사목/NNG
사무	*사무/NNG
사문	*사문/NNG
사물	*사물/NNG
사미	*사미/NNG
사방	*사방/NNG
사배	*사배/NNG
사법	*사법/NNG
사변	*사변/NNG
사별	*사별/NNG
사병	*사병/NNG
사보	*사보/NNG
사복	*사복/NNG
사본	*사본/NNG
사부	*사부/NNG
사비	*사비/NNG
사뿐	*사뿐/MAG
사사	*사사/NNG
사산	*사산/NNG
사살	*사살/NNG
사상	*사상/NNG
사색	*사색/NNG
사생	*사생/NNG
사선	*사선/NNG
사설	*사설/NNG
사성	*사성/NNG
사세	*사세/NNG
사소	*사소/NNG
사수	*사수/NNG
사숙	*사숙/NNG
사순	*사순/NNP
사승	*사승/NNG
사신	*사신/NNG
사악	*사악/NNG
사안	*사안/NNG
사액	*사액/NNG
사약	*사약/NNG
사양	*사양/NNG
사어	*사어/NNG
사언	*사언/NNG
사업	*사업/NNG
사여	*사여/NNG
사역	*사역/NNG
사연	*사연/NNG
사열	*사열/NNG
사영	*사영/NNG
사예	*사예/NNG
사욕	*사욕/NNG
사용	*사용/NNG
사우	*사우/NNG
사원	*사원/NNG
사위	*사위/NNG
사유	*사유/NNG
사육	*사육/NNG
사은	*사은/NNG
사음	*사음/NNG
사의	*사의/NNG
사이	*사이/NNG
사익	*사익/NNG
사인	*사인/NNG
사임	*사임/NNG
사장	*사장/NNG
사적	*사적/NNG
사전	*사전/NNG
사절	*사절/NNG
사정	*사정/NNG
사제	*사제/NNG
사조	*사조/NNG
사죄	*사죄/NNG
사주	*사주/NNG
사중	*사중/NNG
사증	*사증/NNG
사직	*사직/NNG
사진	*사진/NNG
사집	*사집/NNG
사찬	*사찬/NNG
사찰	*사찰/NNG
사처	*사처/NNG
사철	*사철/NNG
사체	*사체/NNG
사초	*사초/NNG
사출	*사출/NNG
사취	*사취/NNG
사치	*사치/NNG
사친	*사친/NNG
사칭	*사칭/NNG
사탄	*사탄/NNG
사토	*사토/NNP
사통	*사통/NNG
사퇴	*사퇴/NNG
사투	*사투/NNG
사판	*사판/NNG
사패	*사패/NNG
사폐	*사폐/NNG
사풋	*사풋/MAG
사피	*사피/NNG
사학	*사학/NNG
사항	*사항/NNG
사해	*사해/NNG
사행	*사행/NNG
사향	*사향/NNG
사현	*사현/NNG
사혈	*사혈/NNG
사형	*사형/NNG
사호	*사호/NNG
사화	*사화/NNG
사환	*사환/NNG
사회	*사회/NNG
사후	*사후/NNG
삭감	*삭감/NNG
삭도	*삭도/NNG
삭발	*삭발/NNG
삭제	*삭제/NNG
삭직	*삭직/NNG
삭탈	*삭탈/NNG
삯일	*삯일/NNG
산개	*산개/NNG
산거	*산거/NNG
산견	*산견/NNG
산고	*산고/NNG
산곡	*산곡/NNG
산대	*산대/NNG
산락	*산락/NNG
산란	*산란/NNG
산매	*산매/NNG
산발	*산발/NNG
산방	*산방/NNG
산보	*산보/NNG
산소	*산소/NNG
산수	*산수/NNG
산술	*산술/NNG
산시	*산시/NNP
산신	*산신/NNG
산실	*산실/NNG
산아	*산아/NNG
산역	*산역/NNG
산울	*산울/NNG
산일	*산일/NNG
산입	*산입/NNG
산장	*산장/NNG
산재	*산재/NNG
산적	*산적/NNG
산정	*산정/NNG
산제	*산제/NNG
산책	*산책/NNG
산출	*산출/NNG
산파	*산파/NNG
산패	*산패/NNG
산포	*산포/NNG
산행	*산행/NNG
산화	*산화/NNG
산회	*산회/NNG
살강	*살강/NNG
살균	*살균/NNG
살랑	*살랑/MAG
살림	*살림/NNG
살벌	*살벌/NNG
살사	*살사/NNG
살살	*살살/MAG
살상	*살상/NNG
살생	*살생/NNG
살수	*살수/NNG
살육	*살육/NNG
살인	*살인/NNG
살충	*살충/NNG
살포	*살포/NNG
살해	*살해/NNG
삶이	*삶이/NNG
삼간	*삼간/NNG
삼경	*삼경/NNG
삼굿	*삼굿/NNG
삼례	*삼례/NNG
삼립	*삼립/NNP
삼배	*삼배/NNG
삼복	*삼복/NNG
삼상	*삼상/NNG
삼선	*삼선/NNG
삼성	*삼성/NNP
삼수	*삼수/NNG
삼숙	*삼숙/NNP
삼작	*삼작/NNG
삼제	*삼제/NNG
삼중	*삼중/NNG
삼창	*삼창/NNG
삼천	*삼천/NR
삼청	*삼청/NNP
삼취	*삼취/NNG
삼투	*삼투/NNG
삼한	*삼한/NNP
삼행	*삼행/NNG
삼헌	*삼헌/NNG
삼황	*삼황/NNP
삽목	*삽목/NNG
삽시	*삽시/NNG
삽입	*삽입/NNG
삽화	*삽화/NNG
상가	*상가/NNG
상각	*상각/NNG
상간	*상간/NNG
상감	*상감/NNG
상거	*상거/NNG
상게	*상게/NNG
상견	*상견/NNG
상경	*상경/NNG
상계	*상계/NNG
상고	*상고/NNG
상공	*상공/NNG
상관	*상관/NNG
상교	*상교/NNG
상구	*상구/NNP
상국	*상국/NNG
상극	*상극/NNG
상근	*상근/NNG
상글	*상글/MAG
상급	*상급/NNG
상기	*상기/NNG
상납	*상납/NNG
상달	*상달/NNG
상담	*상담/NNG
상답	*상답/NNG
상당	*상당/NNG
상대	*상대/NNG
상덕	*상덕/NNP
상동	*상동/NNG
상등	*상등/NNG
상량	*상량/NNG
상례	*상례/NNG
상로	*상로/NNG
상록	*상록/NNG
상론	*상론/NNG
상륙	*상륙/NNG
상리	*상리/NNG
상말	*상말/NNG
상면	*상면/NNG
상명	*상명/NNG
상모	*상모/NNG
상목	*상목/NNG
상무	*상무/NNG
상문	*상문/NNG
상미	*상미/NNP
상박	*상박/NNG
상반	*상반/NNG
상방	*상방/NNG
상배	*상배/NNP
상벌	*상벌/NNG
상변	*상변/NNG
상보	*상보/NNG
상복	*상복/NNG
상봉	*상봉/NNG
상부	*상부/NNG
상비	*상비/NNG
상사	*상사/NNG
상상	*상상/NNG
상생	*상생/NNG
상서	*상서/NNG
상선	*상선/NNG
상설	*상설/NNG
상성	*상성/NNG
상세	*상세/NNG
상소	*상소/NNG
상속	*상속/NNG
상송	*상송/NNG
상쇄	*상쇄/NNG
상수	*상수/NNG
상술	*상술/NNG
상승	*상승/NNG
상시	*상시/NNG
상식	*상식/NNG
상신	*상신/NNG
상실	*상실/NNG
상심	*상심/NNG
상아	*상아/NNG
상약	*상약/NNG
상언	*상언/NNG
상업	*상업/NNG
상여	*상여/NNG
상역	*상역/NNG
상연	*상연/NNG
상영	*상영/NNG
상오	*상오/NNG
상완	*상완/NNG
상욕	*상욕/NNG
상용	*상용/NNG
상응	*상응/NNG
상의	*상의/NNG
상인	*상인/NNG
상일	*상일/NNG
상임	*상임/NNG
상자	*상자/NNG
상잔	*상잔/NNG
상장	*상장/NNG
상재	*상재/NNG
상쟁	*상쟁/NNG
상전	*상전/NNG
상접	*상접/NNG
상정	*상정/NNG
상제	*상제/NNG
상조	*상조/NNG
상존	*상존/NNG
상종	*상종/NNG
상주	*상주/NNG
상준	*상준/NNP
상지	*상지/NNG
상직	*상직/NNG
상징	*상징/NNG
상찬	*상찬/NNG
상처	*상처/NNG
상천	*상천/NNG
상청	*상청/NNG
상체	*상체/NNG
상춘	*상춘/NNG
상충	*상충/NNG
상치	*상치/NNG
상칭	*상칭/NNG
상통	*상통/NNG
상투	*상투/NNG
상패	*상패/NNG
상표	*상표/NNG
상피	*상피/NNG
상학	*상학/NNG
상합	*상합/NNG
상항	*상항/NNG
상핵	*상핵/NNG
상행	*상행/NNG
상향	*상향/NNG
상형	*상형/NNG
상혼	*상혼/NNG
상화	*상화/NNP
상환	*상환/NNG
상회	*상회/NNG
새들	*새들/NNG
새물	*새물/MAG
새벽	*새벽/NNG
새살	*새살/NNG
새새	*새새/MAG
새참	*새참/NNG
새침	*새침/NNG
색사	*색사/NNG
색상	*색상/NNG
색색	*색색/NNG
색원	*색원/NNG
색책	*색책/NNG
색체	*색체/NNG
색출	*색출/NNG
색칠	*색칠/NNG
색탐	*색탐/NNG
샐룩	*샐룩/MAG
샐쭉	*샐쭉/MAG
생각	*생각/NNG
생광	*생광/NNG
생구	*생구/NNG
생글	*생글/MAG
생금	*생금/NNG
생긋	*생긋/MAG
생념	*생념/NNG
생동	*생동/NNG
생뚱	*생뚱/MAG
생략	*생략/NNG
생리	*생리/NNG
생면	*생면/NNG
생멸	*생멸/NNG
생사	*생사/NNG
생산	*생산/NNG
생성	*생성/NNG
생식	*생식/NNG
생신	*생신/NNG
생심	*생심/NNG
생영	*생영/NNG
생육	*생육/NNG
생의	*생의/NNG
생자	*생자/NNG
생장	*생장/NNG
생존	*생존/NNG
생치	*생치/NNG
생포	*생포/NNG
생화	*생화/NNG
생환	*생환/NNG
생활	*생활/NNG
샤워	*샤워/NNG
서간	*서간/NNG
서거	*서거/NNG
서경	*서경/NNP
서계	*서계/NNG
서고	*서고/NNG
서관	*서관/NNP
서기	*서기/NNG
서두	*서두/NNG
서력	*서력/NNG
서록	*서록/NNP
서류	*서류/NNG
서머	*서머/NNG
서명	*서명/NNG
서브	*서브/NNG
서사	*서사/NNG
서상	*서상/NNG
서설	*서설/NNG
서성	*서성/NNG
서수	*서수/NNG
서숙	*서숙/NNG
서술	*서술/NNG
서슴	*서슴/VV
서승	*서승/NNP
서식	*서식/NNG
서실	*서실/NNG
서압	*서압/NNG
서약	*서약/NNG
서역	*서역/NNP
서원	*서원/NNG
서위	*서위/NNP
서유	*서유/NNG
서임	*서임/NNG
서점	*서점/NNG
서정	*서정/NNG
서지	*서지/NNG
서진	*서진/NNG
서창	*서창/NNP
서통	*서통/NNP
서퇴	*서퇴/NNG
서파	*서파/NNG
서푼	*서푼/NNG
서품	*서품/NNG
서하	*서하/NNP
서행	*서행/NNG
서향	*서향/NNG
서훈	*서훈/NNG
석각	*석각/NNG
석곡	*석곡/NNG
석권	*석권/NNG
석대	*석대/NNG
석명	*석명/NNG
석방	*석방/NNG
석별	*석별/NNG
석복	*석복/NNG
석부	*석부/NNG
석산	*석산/NNG
석석	*석석/MAG
석의	*석의/NNG
석전	*석전/NNG
석출	*석출/NNP
석패	*석패/NNG
석화	*석화/NNG
석회	*석회/NNG
선각	*선각/NNG
선감	*선감/NNG
선거	*선거/NNG
선견	*선견/NNG
선결	*선결/NNG
선고	*선고/NNG
선곡	*선곡/NNG
선교	*선교/NNG
선구	*선구/NNG
선군	*선군/NNG
선급	*선급/NNG
선기	*선기/NNG
선나	*선나/NNG
선납	*선납/NNG
선당	*선당/NNG
선대	*선대/NNG
선도	*선도/NNG
선동	*선동/NNG
선득	*선득/MAG
선등	*선등/NNG
선뜩	*선뜩/MAG
선뜻	*선뜻/MAG
선량	*선량/NNG
선망	*선망/NNG
선명	*선명/NNG
선묘	*선묘/NNG
선무	*선무/NNG
선문	*선문/NNG
선물	*선물/NNG
선미	*선미/NNG
선박	*선박/NNG
선반	*선반/NNG
선발	*선발/NNG
선방	*선방/NNG
선별	*선별/NNG
선보	*선보/VV
선분	*선분/NNG
선불	*선불/NNG
선사	*선사/NNG
선산	*선산/NNG
선상	*선상/NNG
선서	*선서/NNG
선수	*선수/NNG
선승	*선승/NNG
선시	*선시/NNG
선약	*선약/NNG
선양	*선양/NNP
선어	*선어/NNG
선언	*선언/NNG
선염	*선염/NNG
선용	*선용/NNG
선우	*선우/NNP
선운	*선운/NNG
선위	*선위/NNG
선유	*선유/NNG
선인	*선인/NNG
선일	*선일/NNP
선임	*선임/NNG
선입	*선입/NNG
선장	*선장/NNG
선재	*선재/NNG
선적	*선적/NNG
선전	*선전/NNG
선점	*선점/NNG
선정	*선정/NNG
선제	*선제/NNG
선종	*선종/NNG
선주	*선주/NNG
선지	*선지/NNG
선진	*선진/NNG
선착	*선착/NNG
선참	*선참/NNG
선창	*선창/NNG
선처	*선처/NNG
선천	*선천/NNG
선출	*선출/NNG
선취	*선취/NNG
선치	*선치/NNG
선탈	*선탈/NNG
선택	*선택/NNG
선통	*선통/NNG
선편	*선편/NNG
선포	*선포/NNG
선하	*선하/VA
선행	*선행/NNG
선현	*선현/NNG
선호	*선호/NNG
선홍	*선홍/NNG
선화	*선화/NNP
선회	*선회/NNG
선후	*선후/NNG
설강	*설강/NNG
설경	*설경/NNG
설계	*설계/NNG
설과	*설과/NNG
설교	*설교/NNG
설국	*설국/NNG
설기	*설기/NNG
설도	*설도/NNG
설득	*설득/NNG
설렁	*설렁/MAG
설립	*설립/NNG
설명	*설명/NNG
설문	*설문/NNG
설법	*설법/NNG
설복	*설복/NNG
설분	*설분/NNG
설비	*설비/NNG
설빔	*설빔/NNG
설설	*설설/MAG
설시	*설시/NNG
설욕	*설욕/NNG
설원	*설원/NNG
설장	*설장/NNG
설전	*설전/NNG
설정	*설정/NNG
설파	*설파/NNG
설핏	*설핏/MAG
설행	*설행/NNG
설화	*설화/NNG
섬뜩	*섬뜩/MAG
섬멸	*섬멸/NNG
섬서	*섬서/NNP
섬세	*섬세/NNG
섬유	*섬유/NNG
섬찍	*섬찍/MAG
섭렵	*섭렵/NNG
섭리	*섭리/NNG
섭생	*섭생/NNG
섭식	*섭식/NNG
섭외	*섭외/NNG
섭이	*섭이/NNP
섭정	*섭정/NNG
섭취	*섭취/NNG
성가	*성가/NNG
성감	*성감/NNG
성격	*성격/NNG
성결	*성결/NNG
성경	*성경/NNG
성골	*성골/NNG
성공	*성공/NNG
성관	*성관/NNG
성교	*성교/NNG
성구	*성구/NNG
성군	*성군/NNG
성글	*성글/VA
성급	*성급/NNG
성냥	*성냥/NNG
성당	*성당/NNG
성덕	*성덕/NNG
성례	*성례/NNG
성립	*성립/NNG
성만	*성만/NNP
성명	*성명/NNG
성묘	*성묘/NNG
성문	*성문/NNG
성별	*성별/NNG
성병	*성병/NNG
성복	*성복/NNG
성분	*성분/NNG
성불	*성불/NNG
성비	*성비/NNG
성사	*성사/NNG
성산	*성산/NNP
성생	*성생/NNG
성석	*성석/NNG
성선	*성선/NNG
성설	*성설/NNP
성성	*성성/NNG
성세	*성세/NNG
성수	*성수/NNG
성숙	*성숙/NNG
성시	*성시/NNG
성식	*성식/NNP
성실	*성실/NNG
성악	*성악/NNG
성안	*성안/NNG
성애	*성애/NNG
성약	*성약/NNG
성어	*성어/NNG
성업	*성업/NNG
성옥	*성옥/NNP
성왕	*성왕/NNP
성원	*성원/NNG
성인	*성인/NNG
성일	*성일/NNG
성자	*성자/NNG
성장	*성장/NNG
성재	*성재/NNP
성적	*성적/NNG
성정	*성정/NNG
성조	*성조/NNG
성종	*성종/NNP
성직	*성직/NNG
성찰	*성찰/NNG
성책	*성책/NNG
성천	*성천/NNP
성첩	*성첩/NNG
성출	*성출/NNG
성충	*성충/NNG
성취	*성취/NNG
성층	*성층/NNG
성큼	*성큼/MAG
성태	*성태/NNP
성토	*성토/NNG
성행	*성행/NNG
성형	*성형/NNG
성혼	*성혼/NNG
성화	*성화/NNG
성회	*성회/NNG
세간	*세간/NNG
세거	*세거/NNG
세계	*세계/NNG
세공	*세공/NNG
세관	*세관/NNG
세납	*세납/NNG
세뇌	*세뇌/NNG
세단	*세단/NNG
세도	*세도/NNG
세련	*세련/NNG
세렴	*세렴/NNG
세론	*세론/NNG
세말	*세말/NNG
세면	*세면/NNG
세모	*세모/NNG
세목	*세목/NNG
세문	*세문/NNG
세미	*세미/NNG
세발	*세발/NNG
세배	*세배/NNG
세분	*세분/NNG
세사	*세사/NNG
세수	*세수/NNG
세습	*세습/NNG
세시	*세시/NNG
세안	*세안/NNG
세일	*세일/NNG
세장	*세장/NNG
세절	*세절/NNG
세정	*세정/NNG
세제	*세제/NNG
세척	*세척/NNG
세탁	*세탁/NNG
세팅	*세팅/NNG
세평	*세평/NNG
세풍	*세풍/NNG
세필	*세필/NNG
세함	*세함/NNG
소각	*소각/NNG
소감	*소감/NNG
소강	*소강/NNG
소개	*소개/NNG
소거	*소거/NNG
소격	*소격/NNG
소견	*소견/NNG
소경	*소경/NNG
소고	*소고/NNG
소과	*소과/NNG
소구	*소구/NNG
소금	*소금/NNG
소급	*소급/NNG
소기	*소기/NNG
소대	*소대/NNG
소도	*소도/NNG
소독	*소독/NNG
소동	*소동/NNG
소두	*소두/NNG
소등	*소등/NNG
소란	*소란/NNG
소량	*소량/NNG
소렴	*소렴/NNG
소루	*소루/NNG
소리	*소리/NNG
소립	*소립/NNG
소마	*소마/NNG
소만	*소만/NNG
소망	*소망/NNG
소매	*소매/NNG
소멸	*소멸/NNG
소명	*소명/NNG
소모	*소모/NNG
소묘	*소묘/NNG
소방	*소방/NNG
소복	*소복/NNG
소분	*소분/NNG
소비	*소비/NNG
소사	*소사/NNG
소산	*소산/NNG
소살	*소살/NNG
소상	*소상/NNG
소색	*소색/NNG
소생	*소생/NNG
소서	*소서/NNG
소설	*소설/NNG
소성	*소성/NNG
소세	*소세/NNG
소속	*소속/NNG
소송	*소송/NNG
소수	*소수/NNG
소승	*소승/NNG
소시	*소시/NNG
소식	*소식/NNG
소신	*소신/NNG
소실	*소실/NNG
소심	*소심/NNG
소아	*소아/NNG
소안	*소안/NNP
소양	*소양/NNG
소언	*소언/NNG
소여	*소여/NNP
소연	*소연/NNP
소염	*소염/NNG
소외	*소외/NNG
소요	*소요/NNG
소욕	*소욕/NNG
소용	*소용/NNG
소우	*소우/NNG
소울	*소울/NNG
소원	*소원/NNG
소유	*소유/NNG
소음	*소음/NNG
소응	*소응/NNG
소의	*소의/NNG
소이	*소이/NNG
소인	*소인/NNG
소일	*소일/NNG
소자	*소자/NNG
소작	*소작/NNG
소장	*소장/NNG
소재	*소재/NNG
소저	*소저/NNG
소적	*소적/NNG
소절	*소절/NNG
소정	*소정/NNG
소제	*소제/NNG
소조	*소조/NNG
소졸	*소졸/NNG
소종	*소종/NNG
소지	*소지/NNG
소진	*소진/NNG
소집	*소집/NNG
소찬	*소찬/NNG
소창	*소창/NNG
소청	*소청/NNG
소체	*소체/NNG
소추	*소추/NNG
소출	*소출/NNG
소치	*소치/NNG
소침	*소침/NNG
소타	*소타/NNP
소탕	*소탕/NNG
소토	*소토/NNP
소통	*소통/NNG
소파	*소파/NNG
소포	*소포/NNG
소풍	*소풍/NNG
소하	*소하/NNP
소학	*소학/NNP
소한	*소한/NNG
소해	*소해/NNG
소행	*소행/NNG
소호	*소호/NNG
소홀	*소홀/NNG
소화	*소화/NNG
소환	*소환/NNG
소회	*소회/NNG
소희	*소희/NNP
속간	*속간/NNG
속개	*속개/NNG
속결	*속결/NNG
속공	*속공/NNG
속기	*속기/NNG
속단	*속단/NNG
속달	*속달/NNG
속대	*속대/NNG
속독	*속독/NNG
속락	*속락/NNG
속량	*속량/NNG
속례	*속례/NNG
속말	*속말/NNG
속박	*속박/NNG
속발	*속발/NNG
속보	*속보/NNG
속사	*속사/NNG
속살	*속살/NNG
속상	*속상/NNG
속성	*속성/NNG
속셈	*속셈/NNG
속수	*속수/NNG
속신	*속신/NNG
속심	*속심/NNG
속악	*속악/NNG
속연	*속연/NNG
속전	*속전/NNG
속죄	*속죄/NNG
속진	*속진/NNG
속초	*속초/NNP
속출	*속출/NNG
속칭	*속칭/NNG
속판	*속판/NNG
속행	*속행/NNG
속현	*속현/NNG
속화	*속화/NNG
속환	*속환/NNG
손괴	*손괴/NNG
손도	*손도/NNG
손복	*손복/NNG
손사	*손사/NNP
손상	*손상/NNG
손순	*손순/NNP
손실	*손실/NNG
손양	*손양/NNG
손위	*손위/NNG
손재	*손재/NNG
손질	*손질/NNG
손짓	*손짓/NNG
손해	*손해/NNG
솔가	*솔가/NNG
솔거	*솔거/NNP
솔선	*솔선/NNG
솔질	*솔질/NNG
송경	*송경/NNP
송고	*송고/NNG
송구	*송구/NNG
송금	*송금/NNG
송기	*송기/NNG
송년	*송년/NNG
송달	*송달/NNG
송덕	*송덕/NNG
송도	*송도/NNP
송독	*송독/NNG
송별	*송별/NNG
송부	*송부/NNG
송사	*송사/NNG
송상	*송상/NNG
송송	*송송/MAG
송수	*송수/NNG
송시	*송시/NNG
송신	*송신/NNG
송영	*송영/NNG
송옥	*송옥/NNP
송장	*송장/NNG
송전	*송전/NNG
송정	*송정/NNP
송종	*송종/NNP
송창	*송창/NNG
송청	*송청/NNP
송축	*송축/NNG
송출	*송출/NNG
송치	*송치/NNG
송탄	*송탄/NNP
송파	*송파/NNP
송풍	*송풍/NNG
송화	*송화/NNP
송환	*송환/NNG
쇄골	*쇄골/NNG
쇄국	*쇄국/NNG
쇄도	*쇄도/NNG
쇄락	*쇄락/NNG
쇄신	*쇄신/NNG
쇠락	*쇠락/NNG
쇠망	*쇠망/NNG
쇠멸	*쇠멸/NNG
쇠미	*쇠미/NNG
쇠약	*쇠약/NNG
쇠잔	*쇠잔/NNG
쇠진	*쇠진/NNG
쇠퇴	*쇠퇴/NNG
쇼핑	*쇼핑/NNG
수각	*수각/NNG
수간	*수간/NNG
수감	*수감/NNG
수강	*수강/NNG
수거	*수거/NNG
수격	*수격/NNG
수결	*수결/NNG
수경	*수경/NNG
수계	*수계/NNG
수고	*수고/NNG
수골	*수골/NNG
수공	*수공/NNG
수관	*수관/NNG
수괴	*수괴/NNG
수교	*수교/NNG
수구	*수구/NNG
수군	*수군/NNG
수궁	*수궁/NNG
수권	*수권/NNG
수금	*수금/NNG
수급	*수급/NNG
수긍	*수긍/NNG
수기	*수기/NNG
수난	*수난/NNG
수납	*수납/NNG
수년	*수년/NNG
수단	*수단/NNG
수달	*수달/NNG
수덕	*수덕/NNP
수두	*수두/NNG
수득	*수득/NNG
수라	*수라/NNG
수락	*수락/NNG
수량	*수량/NNG
수력	*수력/NNG
수련	*수련/NNG
수렴	*수렴/NNG
수렵	*수렵/NNG
수령	*수령/NNG
수로	*수로/NNG
수뢰	*수뢰/NNG
수료	*수료/NNG
수루	*수루/VV
수리	*수리/NNG
수립	*수립/NNG
수마	*수마/NNG
수매	*수매/NNG
수면	*수면/NNG
수명	*수명/NNG
수모	*수모/NNG
수몰	*수몰/NNG
수문	*수문/NNG
수미	*수미/NNP
수박	*수박/NNG
수반	*수반/NNG
수발	*수발/NNG
수방	*수방/NNG
수배	*수배/NNG
수벌	*수벌/NNG
수범	*수범/NNG
수법	*수법/NNG
수변	*수변/NNG
수병	*수병/NNG
수보	*수보/NNG
수복	*수복/NNG
수부	*수부/NNG
수분	*수분/NNG
수불	*수불/NNG
수비	*수비/NNG
수사	*수사/NNG
수삭	*수삭/NNP
수산	*수산/NNG
수상	*수상/NNG
수색	*수색/NNG
수생	*수생/NNG
수서	*수서/NNP
수선	*수선/NNG
수성	*수성/NNG
수세	*수세/NNG
수소	*수소/NNG
수속	*수속/NNG
수송	*수송/NNG
수수	*수수/NNG
수순	*수순/NNG
수술	*수술/NNG
수습	*수습/NNG
수시	*수시/NNG
수식	*수식/NNG
수신	*수신/NNG
수심	*수심/NNG
수아	*수아/NNP
수안	*수안/NNP
수압	*수압/NNG
수양	*수양/NNG
수어	*수어/NNG
수업	*수업/NNG
수여	*수여/NNG
수역	*수역/NNG
수연	*수연/NNP
수영	*수영/NNG
수예	*수예/NNG
수오	*수오/NNG
수요	*수요/NNG
수용	*수용/NNG
수우	*수우/NNG
수운	*수운/NNP
수원	*수원/NNP
수위	*수위/NNG
수유	*수유/NNG
수윤	*수윤/NNP
수은	*수은/NNG
수음	*수음/NNG
수이	*수이/MAG
수익	*수익/NNG
수인	*수인/NNG
수일	*수일/NNG
수임	*수임/NNG
수입	*수입/NNG
수자	*수자/NNG
수작	*수작/NNG
수장	*수장/NNG
수재	*수재/NNG
수전	*수전/NNG
수절	*수절/NNG
수정	*수정/NNG
수제	*수제/NNG
수졸	*수졸/NNG
수종	*수종/NNG
수죄	*수죄/NNG
수주	*수주/NNG
수직	*수직/NNG
수진	*수진/NNP
수집	*수집/NNG
수찬	*수찬/NNP
수참	*수참/NNG
수창	*수창/NNG
수채	*수채/NNG
수책	*수책/NNG
수첩	*수첩/NNG
수축	*수축/NNG
수출	*수출/NNG
수취	*수취/NNG
수칙	*수칙/NNG
수침	*수침/NNG
수탁	*수탁/NNG
수탈	*수탈/NNG
수탐	*수탐/NNG
수태	*수태/NNG
수통	*수통/NNG
수투	*수투/NNG
수판	*수판/NNG
수편	*수편/NNG
수포	*수포/NNG
수학	*수학/NNG
수합	*수합/NNG
수해	*수해/NNG
수행	*수행/NNG
수험	*수험/NNG
수혈	*수혈/NNG
수형	*수형/NNG
수혜	*수혜/NNG
수호	*수호/NNG
수확	*수확/NNG
수훈	*수훈/NNG
숙고	*숙고/NNG
숙달	*숙달/NNG
숙독	*숙독/NNG
숙련	*숙련/NNG
숙망	*숙망/NNG
숙면	*숙면/NNG
숙명	*숙명/NNG
숙박	*숙박/NNG
숙배	*숙배/NNG
숙사	*숙사/NNG
숙성	*숙성/NNG
숙소	*숙소/NNG
숙수	*숙수/NNG
숙시	*숙시/NNG
숙식	*숙식/NNG
숙실	*숙실/NNG
숙연	*숙연/NNG
숙영	*숙영/NNG
숙위	*숙위/NNG
숙의	*숙의/NNG
숙저	*숙저/NNG
숙정	*숙정/NNG
숙제	*숙제/NNG
숙지	*숙지/NNG
숙직	*숙직/NNG
숙청	*숙청/NNG
숙취	*숙취/NNG
숙혜	*숙혜/NNG
순간	*순간/NNG
순검	*순검/NNG
순결	*순결/NNG
순경	*순경/NNG
순교	*순교/NNG
순국	*순국/NNG
순기	*순기/VV
순덕	*순덕/NNP
순도	*순도/NNG
순동	*순동/NNG
순례	*순례/NNG
순리	*순리/NNG
순명	*순명/NNG
순무	*순무/NNG
순문	*순문/NNG
순미	*순미/NNP
순방	*순방/NNG
순배	*순배/NNG
순백	*순백/NNG
순사	*순사/NNG
순산	*순산/NNG
순성	*순성/NNG
순수	*순수/NNG
순시	*순시/NNG
순실	*순실/NNG
순아	*순아/NNP
순안	*순안/NNP
순애	*순애/NNG
순연	*순연/NNG
순열	*순열/NNG
순유	*순유/NNG
순응	*순응/NNG
순의	*순의/NNG
순일	*순일/NNG
순장	*순장/NNG
순절	*순절/NNG
순정	*순정/NNG
순조	*순조/NNG
순종	*순종/NNG
순주	*순주/NNP
순지	*순지/NNP
순직	*순직/NNG
순진	*순진/NNG
순차	*순차/NNG
순찰	*순찰/NNG
순천	*순천/NNP
순치	*순치/NNG
순풍	*순풍/NNG
순항	*순항/NNG
순행	*순행/NNG
순화	*순화/NNG
순환	*순환/NNG
순회	*순회/NNG
술회	*술회/NNG
숭경	*숭경/NNG
숭모	*숭모/NNG
숭문	*숭문/NNG
숭배	*숭배/NNG
숭보	*숭보/VV
숭봉	*숭봉/NNG
숭불	*숭불/NNG
숭상	*숭상/NNG
숭숭	*숭숭/MAG
숭신	*숭신/NNP
숭앙	*숭앙/NNG
숭유	*숭유/NNG
숭조	*숭조/NNG
쉑쉑	*쉑쉑/MAG
쉬쉬	*쉬쉬/MAG
쉭쉭	*쉭쉭/MAG
슈팅	*슈팅/NNG
스륵	*스륵/MAG
슬슬	*슬슬/MAG
슬쩍	*슬쩍/MAG
습격	*습격/NNG
습득	*습득/NNG
습래	*습래/NNG
습렴	*습렴/NNG
습생	*습생/NNG
습윤	*습윤/NNG
습의	*습의/NNG
습자	*습자/NNG
습작	*습작/NNG
습지	*습지/NNG
습진	*습진/NNG
습합	*습합/NNG
승격	*승격/NNG
승계	*승계/NNG
승공	*승공/NNG
승급	*승급/NNG
승기	*승기/NNG
승낙	*승낙/NNG
승단	*승단/NNG
승당	*승당/NNG
승리	*승리/NNG
승마	*승마/NNG
승명	*승명/NNG
승무	*승무/NNG
승문	*승문/NNG
승복	*승복/NNG
승부	*승부/NNG
승사	*승사/NNG
승선	*승선/NNG
승세	*승세/NNG
승소	*승소/NNG
승수	*승수/NNG
승승	*승승/NNG
승시	*승시/NNG
승인	*승인/NNG
승자	*승자/NNG
승전	*승전/NNG
승직	*승직/NNG
승진	*승진/NNG
승질	*승질/NNG
승차	*승차/NNG
승천	*승천/NNG
승첩	*승첩/NNG
승패	*승패/NNG
승합	*승합/NNG
승화	*승화/NNG
시거	*시거/NNG
시공	*시공/NNG
시구	*시구/NNG
시굴	*시굴/NNG
시극	*시극/NNG
시급	*시급/NNG
시기	*시기/NNG
시늉	*시늉/NNG
시달	*시달/NNG
시도	*시도/NNG
시독	*시독/NNG
시동	*시동/NNG
시들	*시들/VV
시련	*시련/NNG
시료	*시료/NNG
시립	*시립/NNG
시명	*시명/NNG
시무	*시무/NNG
시문	*시문/NNG
시물	*시물/NR
시발	*시발/NNG
시방	*시방/MAG
시배	*시배/NNG
시범	*시범/NNG
시복	*시복/NNG
시봉	*시봉/NNG
시비	*시비/NNG
시사	*시사/NNG
시산	*시산/NNG
시상	*시상/NNG
시샘	*시샘/NNG
시생	*시생/NP
시선	*시선/NNG
시설	*시설/NNG
시성	*시성/NNG
시술	*시술/NNG
시습	*시습/NNP
시승	*시승/NNG
시식	*시식/NNG
시실	*시실/NNG
시심	*시심/NNG
시악	*시악/NNG
시약	*시약/NNG
시양	*시양/NNG
시어	*시어/NNG
시업	*시업/NNG
시역	*시역/NNG
시연	*시연/NNG
시영	*시영/NNG
시예	*시예/NNG
시오	*시오/NR
시외	*시외/NNG
시용	*시용/NNG
시위	*시위/NNG
시유	*시유/NNG
시은	*시은/NNG
시음	*시음/NNG
시의	*시의/NNG
시인	*시인/NNG
시작	*시작/NNG
시장	*시장/NNG
시재	*시재/NNG
시정	*시정/NNG
시제	*시제/NNG
시조	*시조/NNG
시주	*시주/NNG
시중	*시중/NNG
시진	*시진/NNG
시집	*시집/NNG
시찰	*시찰/NNG
시창	*시창/NNG
시책	*시책/NNG
시철	*시철/NNG
시청	*시청/NNG
시초	*시초/NNG
시추	*시추/NNG
시취	*시취/NNG
시침	*시침/NNG
시탄	*시탄/NNG
시탕	*시탕/NNG
시판	*시판/NNG
시필	*시필/NNG
시학	*시학/NNG
시한	*시한/NNG
시합	*시합/NNG
시해	*시해/NNG
시행	*시행/NNG
시험	*시험/NNG
시현	*시현/NNG
시혜	*시혜/NNG
시호	*시호/NNG
시화	*시화/NNG
식고	*식고/NNG
식리	*식리/NNG
식모	*식모/NNG
식목	*식목/NNG
식미	*식미/NNG
식민	*식민/NNG
식별	*식별/NNG
식부	*식부/NNG
식사	*식사/NNG
식산	*식산/NNG
식상	*식상/NNG
식수	*식수/NNG
식언	*식언/NNG
식용	*식용/NNG
식육	*식육/NNG
식음	*식음/NNG
식자	*식자/NNG
식장	*식장/NNG
식재	*식재/NNG
식탐	*식탐/NNG
식판	*식판/NNG
신간	*신간/NNG
신검	*신검/NNG
신격	*신격/NNG
신계	*신계/NNP
신고	*신고/NNG
신공	*신공/NNG
신교	*신교/NNG
신구	*신구/NNG
신국	*신국/NNG
신근	*신근/NNG
신단	*신단/NNG
신독	*신독/NNG
신령	*신령/NNG
신로	*신로/NNG
신뢰	*신뢰/NNG
신림	*신림/NNP
신립	*신립/NNP
신망	*신망/NNG
신명	*신명/NNG
신묘	*신묘/NNG
신문	*신문/NNG
신미	*신미/NNG
신발	*신발/NNG
신방	*신방/NNG
신보	*신보/NNG
신복	*신복/NNG
신봉	*신봉/NNG
신부	*신부/NNG
신비	*신비/NNG
신빙	*신빙/NNG
신사	*신사/NNG
신산	*신산/NNG
신색	*신색/NNG
신생	*신생/NNG
신서	*신서/NNG
신석	*신석/NNP
신선	*신선/NNG
신설	*신설/NNG
신섭	*신섭/NNP
신성	*신성/NNG
신소	*신소/NNG
신속	*신속/NNG
신수	*신수/NNG
신승	*신승/NNG
신시	*신시/NNP
신실	*신실/NNG
신알	*신알/NNG
신앙	*신앙/NNG
신애	*신애/NNP
신약	*신약/NNG
신역	*신역/NNG
신열	*신열/NNG
신영	*신영/NNP
신예	*신예/NNG
신원	*신원/NNG
신위	*신위/NNG
신유	*신유/NNG
신음	*신음/NNG
신읍	*신읍/NNP
신의	*신의/NNG
신인	*신인/NNG
신임	*신임/NNG
신입	*신입/NNG
신작	*신작/NNG
신전	*신전/NNG
신접	*신접/NNG
신정	*신정/NNG
신조	*신조/NNG
신종	*신종/NNG
신주	*신주/NNG
신중	*신중/NNG
신지	*신지/NNP
신진	*신진/NNG
신착	*신착/NNG
신찬	*신찬/NNG
신참	*신참/NNG
신창	*신창/NNP
신청	*신청/NNG
신축	*신축/NNG
신출	*신출/NNG
신취	*신취/NNG
신칙	*신칙/NNG
신탁	*신탁/NNG
신통	*신통/NNG
신판	*신판/NNG
신해	*신해/NNP
신행	*신행/NNG
신호	*신호/NNG
신혼	*신혼/NNG
신화	*신화/NNG
신효	*신효/NNG
신흥	*신흥/NNG
실각	*실각/NNG
실감	*실감/NNG
실격	*실격/NNG
실견	*실견/NNG
실경	*실경/NNG
실구	*실구/NNG
실권	*실권/NNG
실금	*실금/NNG
실기	*실기/NNG
실농	*실농/NNG
실덕	*실덕/NNG
실량	*실량/NNG
실례	*실례/NNG
실망	*실망/NNG
실명	*실명/NNG
실물	*실물/NNG
실사	*실사/NNG
실색	*실색/NNG
실성	*실성/NNG
실세	*실세/NNG
실소	*실소/NNG
실속	*실속/NNG
실습	*실습/NNG
실시	*실시/NNG
실신	*실신/NNG
실실	*실실/MAG
실언	*실언/NNG
실업	*실업/NNG
실연	*실연/NNG
실용	*실용/NNG
실원	*실원/NNG
실음	*실음/NNG
실의	*실의/NNG
실재	*실재/NNG
실적	*실적/NNG
실전	*실전/NNG
실절	*실절/NNG
실점	*실점/NNG
실정	*실정/NNG
실조	*실조/NNG
실족	*실족/NNG
실존	*실존/NNG
실종	*실종/NNG
실증	*실증/NNG
실지	*실지/NNG
실직	*실직/NNG
실쭉	*실쭉/MAG
실천	*실천/NNG
실체	*실체/NNG
실추	*실추/NNG
실축	*실축/NNG
실측	*실측/NNG
실토	*실토/NNG
실파	*실파/NNG
실패	*실패/NNG
실함	*실함/NNG
실행	*실행/NNG
실향	*실향/NNG
실험	*실험/NNG
실현	*실현/NNG
실화	*실화/NNG
실효	*실효/NNG
심각	*심각/NNG
심검	*심검/NNG
심경	*심경/NNG
심계	*심계/NNG
심고	*심고/NNG
심구	*심구/NNG
심급	*심급/NNG
심단	*심단/NNG
심대	*심대/NNG
심도	*심도/NNG
심려	*심려/NNG
심로	*심로/NNG
심리	*심리/NNG
심문	*심문/NNG
심박	*심박/NNG
심방	*심방/NNG
심벽	*심벽/NNG
심복	*심복/NNG
심사	*심사/NNG
심산	*심산/NNG
심상	*심상/NNG
심성	*심성/NNG
심수	*심수/NNG
심시	*심시/NNG
심신	*심신/NNG
심안	*심안/NNG
심약	*심약/NNG
심우	*심우/NNG
심원	*심원/NNG
심의	*심의/NNG
심인	*심인/NNG
심장	*심장/NNG
심정	*심정/NNG
심중	*심중/NNG
심청	*심청/NNP
심축	*심축/NNG
심취	*심취/NNG
심통	*심통/NNG
심판	*심판/NNG
심허	*심허/VA
심화	*심화/NNG
심회	*심회/NNG
십념	*십념/NNG
싱긋	*싱긋/MAG
싱싱	*싱싱/MAG
싸리	*싸리/NNG
싸움	*싸움/NNG
싹둑	*싹둑/MAG
싹싹	*싹싹/MAG
쌈박	*쌈박/NNG
쌈빡	*쌈빡/NNG
쌍글	*쌍글/MAG
쌍끗	*쌍끗/MAG
쌍둥	*쌍둥/NNG
쌍말	*쌍말/NNG
쌍융	*쌍융/NNG
쌍태	*쌍태/NNG
쌕쌕	*쌕쌕/MAG
쌩긋	*쌩긋/MAG
쌩쌩	*쌩쌩/MAG
썩썩	*썩썩/MAG
썰렁	*썰렁/MAG
썰썰	*썰썰/MAG
썸뻑	*썸뻑/MAG
쓱싹	*쓱싹/MAG
씨름	*씨름/NNG
씨불	*씨불/NNG
씩씩	*씩씩/MAG
씽글	*씽글/NNG
씽긋	*씽긋/MAG
씽씽	*씽씽/MAG
아담	*아담/NNP
아당	*아당/NNG
아도	*아도/NNP
아롱	*아롱/NNG
아물	*아물/VV
아미	*아미/NNG
아부	*아부/NNG
아빈	*아빈/NNP
아사	*아사/NNG
아삭	*아삭/NNP
아아	*아아/IC
아유	*아유/IC
아종	*아종/NNG
아첨	*아첨/NNG
아편	*아편/NNG
아헌	*아헌/NNG
아호	*아호/NNG
악담	*악담/NNG
악덕	*악덕/NNG
악독	*악독/NNG
악랄	*악랄/NNG
악매	*악매/NNG
악수	*악수/NNG
악악	*악악/MAG
악어	*악어/NNG
악언	*악언/NNG
악연	*악연/NNG
악용	*악용/NNG
악지	*악지/NNG
악착	*악착/NNG
악평	*악평/NNG
악형	*악형/NNG
악화	*악화/NNG
안강	*안강/NNP
안거	*안거/NNG
안검	*안검/NNG
안견	*안견/NNP
안과	*안과/NNG
안국	*안국/NNP
안내	*안내/NNG
안달	*안달/NNG
안대	*안대/NNG
안돈	*안돈/NNG
안동	*안동/NNP
안락	*안락/NNG
안마	*안마/NNG
안면	*안면/NNG
안무	*안무/NNG
안민	*안민/NNG
안배	*안배/NNG
안변	*안변/NNP
안복	*안복/NNG
안부	*안부/NNG
안빈	*안빈/NNG
안산	*안산/NNP
안상	*안상/NNG
안서	*안서/NNP
안수	*안수/NNG
안시	*안시/NNP
안식	*안식/NNG
안심	*안심/NNG
안양	*안양/NNP
안위	*안위/NNG
안유	*안유/NNG
안일	*안일/NNG
안장	*안장/NNG
안전	*안전/NNG
안정	*안정/NNG
안존	*안존/NNG
안집	*안집/NNG
안착	*안착/NNG
안출	*안출/NNG
안타	*안타/NNG
안태	*안태/NNG
안택	*안택/NNG
안향	*안향/NNP
안회	*안회/NNG
알뜰	*알뜰/NNG
알랑	*알랑/NNG
알선	*알선/NNG
알소	*알소/NNG
알속	*알속/NNG
알음	*알음/NNG
알현	*알현/NNG
암거	*암거/NNG
암기	*암기/NNG
암류	*암류/NNG
암막	*암막/NNG
암매	*암매/NNG
암묵	*암묵/NNG
암보	*암보/NNG
암사	*암사/NNP
암산	*암산/NNG
암살	*암살/NNG
암상	*암상/NNG
암색	*암색/NNG
암석	*암석/NNG
암소	*암소/NNG
암송	*암송/NNG
암시	*암시/NNG
암약	*암약/NNG
암양	*암양/NNG
암연	*암연/NNG
암영	*암영/NNG
암울	*암울/NNG
암자	*암자/NNG
암장	*암장/NNG
암전	*암전/NNG
암주	*암주/NNG
암초	*암초/NNG
암투	*암투/NNG
암표	*암표/NNG
암행	*암행/NNG
암흑	*암흑/NNG
압도	*압도/NNG
압류	*압류/NNG
압박	*압박/NNG
압복	*압복/NNG
압사	*압사/NNG
압살	*압살/NNG
압상	*압상/NNG
압설	*압설/NNG
압송	*압송/NNG
압수	*압수/NNG
압슬	*압슬/NNG
압승	*압승/NNG
압연	*압연/NNG
압운	*압운/NNG
압인	*압인/NNG
압제	*압제/NNG
압착	*압착/NNG
압축	*압축/NNG
압출	*압출/NNG
앙급	*앙급/NNG
앙등	*앙등/NNG
앙련	*앙련/NNG
앙모	*앙모/NNG
앙살	*앙살/NNG
앙소	*앙소/NNP
앙앙	*앙앙/MAG
앙장	*앙장/NNG
앙천	*앙천/NNG
앙탈	*앙탈/NNG
앞뒤	*앞뒤/NNG
애감	*애감/NNG
애걸	*애걸/NNG
애견	*애견/NNG
애경	*애경/NNP
애고	*애고/IC
애곡	*애곡/NNG
애교	*애교/NNG
애국	*애국/NNG
애기	*애기/NNG
애도	*애도/NNG
애독	*애독/NNG
애련	*애련/NNG
애리	*애리/NNP
애림	*애림/NNG
애모	*애모/NNG
애무	*애무/NNG
애민	*애민/NNG
애사	*애사/NNG
애상	*애상/NNG
애석	*애석/NNG
애소	*애소/NNG
애송	*애송/NNG
애압	*애압/NNG
애완	*애완/NNG
애요	*애요/NNG
애용	*애용/NNG
애원	*애원/NNG
애음	*애음/NNG
애인	*애인/NNG
애자	*애자/NNG
애조	*애조/NNG
애족	*애족/NNG
애집	*애집/NNG
애착	*애착/NNG
애창	*애창/NNG
애청	*애청/NNG
애총	*애총/NNG
애타	*애타/VV
애통	*애통/NNG
애한	*애한/NNG
애향	*애향/NNG
애호	*애호/NNG
애휼	*애휼/NNG
액땜	*액땜/NNG
액살	*액살/NNG
액수	*액수/NNG
액화	*액화/NNG
앵앵	*앵앵/MAG
야경	*야경/NNG
야곡	*야곡/NNG
야근	*야근/NNG
야금	*야금/NNG
야기	*야기/NNG
야단	*야단/NNG
야료	*야료/NNG
야매	*야매/NNG
야물	*야물/VA
야사	*야사/NNG
야생	*야생/NNG
야속	*야속/NNG
야식	*야식/NNG
야심	*야심/NNG
야영	*야영/NNG
야유	*야유/NNG
야음	*야음/NNG
야장	*야장/NNG
야적	*야적/NNG
야투	*야투/NNG
야학	*야학/NNG
야합	*야합/NNG
야행	*야행/NNG
야화	*야화/NNG
야회	*야회/NNG
약기	*약기/NNG
약동	*약동/NNG
약변	*약변/NNG
약분	*약분/NNG
약비	*약비/NNG
약산	*약산/NNP
약서	*약서/NNG
약속	*약속/NNG
약속	*약속/NNG
약술	*약술/NNG
약여	*약여/NNG
약용	*약용/NNG
약정	*약정/NNG
약조	*약조/NNG
약주	*약주/NNG
약지	*약지/NNG
약진	*약진/NNG
약질	*약질/NNG
약취	*약취/NNG
약칠	*약칠/NNG
약칭	*약칭/NNG
약탈	*약탈/NNG
약하	*약하/VA
약해	*약해/NNG
약혼	*약혼/NNG
약화	*약화/NNG
약회	*약회/NNG
얌전	*얌전/NNG
양각	*양각/NNG
양건	*양건/NNP
양계	*양계/NNG
양공	*양공/NNG
양광	*양광/NNG
양구	*양구/NNP
양기	*양기/NNG
양난	*양난/NNG
양념	*양념/NNG
양노	*양노/NNG
양단	*양단/NNG
양덕	*양덕/NNP
양도	*양도/NNG
양돈	*양돈/NNG
양동	*양동/NNG
양두	*양두/NNG
양득	*양득/NNG
양로	*양로/NNG
양륙	*양륙/NNG
양립	*양립/NNG
양망	*양망/NNG
양명	*양명/NNP
양목	*양목/NNG
양발	*양발/NNG
양병	*양병/NNG
양보	*양보/NNG
양봉	*양봉/NNG
양분	*양분/NNG
양비	*양비/NNG
양사	*양사/NNG
양산	*양산/NNG
양삼	*양삼/NNG
양생	*양생/NNG
양서	*양서/NNG
양선	*양선/NNP
양성	*양성/NNG
양손	*양손/NNG
양수	*양수/NNG
양순	*양순/NNG
양식	*양식/NNG
양실	*양실/NNG
양심	*양심/NNG
양악	*양악/NNG
양안	*양안/NNG
양양	*양양/NNP
양어	*양어/NNG
양여	*양여/NNG
양옥	*양옥/NNG
양용	*양용/NNG
양위	*양위/NNG
양육	*양육/NNG
양일	*양일/NNG
양자	*양자/NNG
양잠	*양잠/NNG
양장	*양장/NNG
양재	*양재/NNP
양전	*양전/NNG
양절	*양절/NNG
양정	*양정/NNG
양제	*양제/NNP
양조	*양조/NNG
양존	*양존/NNG
양주	*양주/NNG
양지	*양지/NNG
양진	*양진/NNP
양초	*양초/NNG
양축	*양축/NNG
양치	*양치/NNG
양친	*양친/NNG
양토	*양토/NNG
양편	*양편/NNG
양해	*양해/NNG
양행	*양행/NNG
양허	*양허/NNG
양현	*양현/NNG
양형	*양형/NNG
양호	*양호/NNG
양화	*양화/NNG
양회	*양회/NNG
얘기	*얘기/NNG
어관	*어관/NNG
어동	*어동/NNG
어란	*어란/NNG
어람	*어람/NNG
어로	*어로/NNG
어른	*어른/NNG
어름	*어름/NNG
어림	*어림/NNG
어마	*어마/IC
어문	*어문/NNG
어물	*어물/NNG
어사	*어사/NNG
어세	*어세/NNG
어순	*어순/NNG
어인	*어인/MM
어적	*어적/NNG
어전	*어전/NNG
어정	*어정/NNG
어조	*어조/NNG
어중	*어중/NNG
어질	*어질/VA
어찌	*어찌/MAG
어필	*어필/NNG
어한	*어한/NNG
어획	*어획/NNG
억류	*억류/NNG
억불	*억불/NNG
억색	*억색/NNG
억설	*억설/NNG
억압	*억압/NNG
억양	*억양/NNG
억억	*억억/MAG
억제	*억제/NNG
억지	*억지/NNG
억측	*억측/NNG
억탁	*억탁/NNG
억탈	*억탈/NNG
언권	*언권/NNG
언급	*언급/NNG
언도	*언도/NNG
언뜻	*언뜻/MAG
언명	*언명/NNG
언설	*언설/NNG
언술	*언술/NNG
언약	*언약/NNG
언쟁	*언쟁/NNG
언중	*언중/NNG
언진	*언진/NNP
언해	*언해/NNG
얼간	*얼간/NNG
얼렁	*얼렁/MAG
얼른	*얼른/MAG
얼씬	*얼씬/MAG
엄계	*엄계/NNG
엄금	*엄금/NNG
엄단	*엄단/NNG
엄매	*엄매/NNG
엄명	*엄명/NNG
엄벌	*엄벌/NNG
엄살	*엄살/NNG
엄선	*엄선/NNG
엄수	*엄수/NNG
엄습	*엄습/NNG
엄이	*엄이/NNP
엄장	*엄장/NNG
엄절	*엄절/NNG
엄존	*엄존/NNG
엄칙	*엄칙/NNG
엄폐	*엄폐/NNG
엄포	*엄포/NNG
엄호	*엄호/NNG
업무	*업무/NNG
없이	*없이/MAG
엉엉	*엉엉/MAG
에테	*에테/NNP
여간	*여간/MAG
여공	*여공/NNG
여과	*여과/NNG
여구	*여구/NNG
여류	*여류/NNG
여망	*여망/NNG
여문	*여문/NNG
여미	*여미/VV
여법	*여법/NNG
여복	*여복/NNG
여북	*여북/MAG
여비	*여비/NNG
여사	*여사/NNG
여상	*여상/NNG
여색	*여색/NNG
여성	*여성/NNG
여수	*여수/NNP
여식	*여식/NNG
여신	*여신/NNG
여실	*여실/NNG
여아	*여아/NNG
여열	*여열/NNG
여염	*여염/NNG
여우	*여우/NNG
여일	*여일/NNG
여장	*여장/NNG
여전	*여전/NNG
여정	*여정/NNG
여짓	*여짓/NNG
여창	*여창/NNG
여천	*여천/NNP
여축	*여축/NNG
여탈	*여탈/NNG
여하	*여하/NNG
여행	*여행/NNG
여흥	*여흥/NNG
역격	*역격/NNG
역공	*역공/NNG
역관	*역관/NNG
역도	*역도/NNG
역동	*역동/NNG
역류	*역류/NNG
역린	*역린/NNG
역모	*역모/NNG
역방	*역방/NNG
역복	*역복/NNG
역사	*역사/NNG
역산	*역산/NNG
역살	*역살/NNG
역상	*역상/NNG
역서	*역서/NNG
역설	*역설/NNG
역성	*역성/NNG
역수	*역수/NNG
역순	*역순/NNG
역술	*역술/NNG
역습	*역습/NNG
역시	*역시/MAG
역신	*역신/NNG
역역	*역역/NNG
역용	*역용/NNG
역임	*역임/NNG
역작	*역작/NNG
역장	*역장/NNG
역전	*역전/NNG
역정	*역정/NNG
역조	*역조/NNG
역주	*역주/NNG
역진	*역진/NNG
역천	*역천/NNG
역체	*역체/NNG
역치	*역치/NNG
역투	*역투/NNG
역풍	*역풍/NNG
역학	*역학/NNG
역해	*역해/NNG
역행	*역행/NNG
역혼	*역혼/NNG
연거	*연거/NNG
연결	*연결/NNG
연경	*연경/NNP
연계	*연계/NNG
연고	*연고/NNG
연공	*연공/NNG
연관	*연관/NNG
연구	*연구/NNG
연극	*연극/NNG
연금	*연금/NNG
연기	*연기/NNG
연길	*연길/NNP
연납	*연납/NNG
연년	*연년/NNG
연단	*연단/NNG
연달	*연달/VV
연대	*연대/NNG
연도	*연도/NNG
연동	*연동/NNG
연등	*연등/NNG
연락	*연락/NNG
연로	*연로/NNG
연루	*연루/NNG
연륙	*연륙/NNG
연립	*연립/NNG
연마	*연마/NNG
연만	*연만/NNG
연맹	*연맹/NNG
연면	*연면/NNG
연명	*연명/NNG
연모	*연모/NNG
연무	*연무/NNG
연미	*연미/NNG
연민	*연민/NNG
연발	*연발/NNG
연병	*연병/NNG
연보	*연보/NNG
연복	*연복/NNG
연봉	*연봉/NNG
연불	*연불/NNG
연비	*연비/NNG
연사	*연사/NNG
연상	*연상/NNG
연서	*연서/NNG
연석	*연석/NNG
연설	*연설/NNG
연성	*연성/NNG
연소	*연소/NNG
연속	*연속/NNG
연쇄	*연쇄/NNG
연수	*연수/NNG
연술	*연술/NNG
연습	*연습/NNG
연승	*연승/NNG
연시	*연시/NNG
연식	*연식/NNG
연신	*연신/MAG
연실	*연실/NNG
연심	*연심/NNG
연안	*연안/NNG
연애	*연애/NNG
연역	*연역/NNG
연예	*연예/NNG
연우	*연우/NNP
연원	*연원/NNG
연월	*연월/NNG
연유	*연유/NNG
연음	*연음/NNG
연의	*연의/NNG
연인	*연인/NNG
연일	*연일/NNG
연임	*연임/NNG
연작	*연작/NNG
연장	*연장/NNG
연재	*연재/NNG
연적	*연적/NNG
연전	*연전/NNG
연접	*연접/NNG
연정	*연정/NNG
연제	*연제/NNG
연조	*연조/NNG
연좌	*연좌/NNG
연주	*연주/NNG
연중	*연중/NNG
연지	*연지/NNG
연차	*연차/NNG
연착	*연착/NNG
연찬	*연찬/NNG
연천	*연천/NNP
연철	*연철/NNG
연청	*연청/NNG
연체	*연체/NNG
연축	*연축/NNG
연출	*연출/NNG
연침	*연침/NNG
연타	*연타/NNG
연탄	*연탄/NNG
연통	*연통/NNG
연파	*연파/NNG
연판	*연판/NNG
연패	*연패/NNG
연폭	*연폭/NNG
연풍	*연풍/NNG
연한	*연한/NNG
연합	*연합/NNG
연행	*연행/NNG
연향	*연향/NNG
연호	*연호/NNG
연혼	*연혼/NNG
연화	*연화/NNG
연회	*연회/NNG
연훈	*연훈/NNP
열거	*열거/NNG
열광	*열광/NNG
열기	*열기/NNG
열독	*열독/NNG
열등	*열등/NNG
열락	*열락/NNG
열람	*열람/NNG
열립	*열립/NNG
열망	*열망/NNG
열매	*열매/NNG
열무	*열무/NNG
열반	*열반/NNG
열변	*열변/NNG
열병	*열병/NNG
열복	*열복/NNG
열석	*열석/NNG
열애	*열애/NNG
열연	*열연/NNG
열중	*열중/NNG
열창	*열창/NNG
열치	*열치/VV
열투	*열투/NNG
열파	*열파/NNG
열패	*열패/NNG
열하	*열하/NNP
염기	*염기/NNG
염담	*염담/NNG
염려	*염려/NNG
염문	*염문/NNG
염발	*염발/NNG
염병	*염병/NNG
염불	*염불/NNG
염산	*염산/NNG
염색	*염색/NNG
염서	*염서/NNG
염세	*염세/NNG
염수	*염수/NNG
염습	*염습/NNG
염식	*염식/NNG
염염	*염염/NNG
염오	*염오/NNG
염원	*염원/NNG
염인	*염인/NNG
염장	*염장/NNG
염전	*염전/NNG
염정	*염정/NNG
염제	*염제/NNP
염직	*염직/NNG
염찰	*염찰/NNG
염출	*염출/NNG
염탐	*염탐/NNG
염화	*염화/NNG
엽관	*엽관/NNG
엽기	*엽기/NNG
엽렵	*엽렵/NNG
엽색	*엽색/NNG
영가	*영가/NNG
영각	*영각/NNG
영거	*영거/NNG
영건	*영건/NNG
영검	*영검/NNG
영결	*영결/NNG
영공	*영공/NNG
영광	*영광/NNG
영교	*영교/NNG
영구	*영구/NNG
영군	*영군/NNG
영기	*영기/NNG
영농	*영농/NNG
영단	*영단/NNG
영달	*영달/NNG
영동	*영동/NNP
영득	*영득/NNG
영락	*영락/NNG
영란	*영란/NNG
영력	*영력/NNG
영령	*영령/NNG
영리	*영리/NNG
영림	*영림/NNG
영만	*영만/NNP
영매	*영매/NNG
영면	*영면/NNG
영문	*영문/NNG
영물	*영물/NNG
영미	*영미/NNP
영변	*영변/NNP
영별	*영별/NNG
영복	*영복/NNP
영봉	*영봉/NNG
영부	*영부/NNG
영분	*영분/NNG
영사	*영사/NNG
영산	*영산/NNG
영상	*영상/NNG
영색	*영색/NNG
영생	*영생/NNG
영서	*영서/NNP
영선	*영선/NNG
영성	*영성/NNG
영세	*영세/NNG
영속	*영속/NNG
영솔	*영솔/NNG
영송	*영송/NNG
영수	*영수/NNG
영시	*영시/NNG
영식	*영식/NNG
영신	*영신/NNG
영실	*영실/NNP
영아	*영아/NNG
영안	*영안/NNP
영양	*영양/NNG
영어	*영어/NNP
영업	*영업/NNG
영역	*영역/NNG
영영	*영영/MAG
영예	*영예/NNG
영우	*영우/NNP
영원	*영원/NNG
영월	*영월/NNP
영위	*영위/NNG
영유	*영유/NNG
영음	*영음/NNG
영의	*영의/NNG
영인	*영인/NNG
영입	*영입/NNG
영작	*영작/NNG
영장	*영장/NNG
영전	*영전/NNG
영접	*영접/NNG
영정	*영정/NNG
영조	*영조/NNP
영존	*영존/NNG
영종	*영종/NNP
영주	*영주/NNG
영준	*영준/NNP
영진	*영진/NNP
영철	*영철/NNP
영축	*영축/NNG
영치	*영치/NNG
영친	*영친/NNG
영탄	*영탄/NNG
영토	*영토/NNG
영통	*영통/NNP
영패	*영패/NNG
영한	*영한/NNG
영합	*영합/NNG
영항	*영항/NNG
영해	*영해/NNG
영행	*영행/NNG
영향	*영향/NNG
영험	*영험/NNG
영현	*영현/NNG
영화	*영화/NNG
영활	*영활/NNG
예각	*예각/NNG
예감	*예감/NNG
예거	*예거/NNG
예견	*예견/NNG
예고	*예고/NNG
예궐	*예궐/NNG
예금	*예금/NNG
예기	*예기/NNG
예납	*예납/NNG
예단	*예단/NNG
예대	*예대/NNG
예리	*예리/NNP
예망	*예망/NNG
예매	*예매/NNG
예명	*예명/NNG
예모	*예모/NNG
예문	*예문/NNG
예방	*예방/NNG
예배	*예배/NNG
예보	*예보/NNG
예복	*예복/NNG
예봉	*예봉/NNG
예부	*예부/NNG
예불	*예불/NNG
예비	*예비/NNG
예사	*예사/NNG
예산	*예산/NNG
예상	*예상/NNG
예선	*예선/NNG
예속	*예속/NNG
예송	*예송/NNG
예수	*예수/NNP
예습	*예습/NNG
예시	*예시/NNG
예악	*예악/NNG
예안	*예안/NNP
예약	*예약/NNG
예양	*예양/NNG
예언	*예언/NNG
예열	*예열/NNG
예예	*예예/IC
예우	*예우/NNG
예인	*예인/NNG
예입	*예입/NNG
예장	*예장/NNG
예정	*예정/NNG
예제	*예제/NNG
예종	*예종/NNP
예증	*예증/NNG
예지	*예지/NNG
예찬	*예찬/NNG
예찰	*예찰/NNG
예축	*예축/NNG
예측	*예측/NNG
예치	*예치/NNG
예탁	*예탁/NNG
예편	*예편/NNG
예하	*예하/NNG
예항	*예항/NNG
예행	*예행/NNG
예후	*예후/NNG
옛말	*옛말/NNG
오감	*오감/NNG
오기	*오기/NNG
오뇌	*오뇌/NNG
오달	*오달/NNP
오답	*오답/NNG
오도	*오도/NNG
오독	*오독/NNG
오뚝	*오뚝/MAG
오락	*오락/NNG
오문	*오문/NNG
오물	*오물/NNG
오발	*오발/NNG
오보	*오보/NNG
오복	*오복/NNG
오사	*오사/NNG
오살	*오살/NNG
오상	*오상/NNG
오손	*오손/NNG
오식	*오식/NNG
오심	*오심/NNG
오싹	*오싹/MAG
오역	*오역/NNG
오연	*오연/NNG
오열	*오열/NNG
오염	*오염/NNG
오예	*오예/NNG
오오	*오오/IC
오욕	*오욕/NNG
오용	*오용/NNG
오이	*오이/NNG
오인	*오인/NNG
오입	*오입/NNG
오장	*오장/NNG
오전	*오전/NNG
오조	*오조/NNG
오죽	*오죽/MAG
오중	*오중/NNG
오직	*오직/MAG
오진	*오진/NNG
오치	*오치/NNG
오타	*오타/NNG
오탁	*오탁/NNG
오판	*오판/NNG
오폭	*오폭/NNG
오한	*오한/NNG
오해	*오해/NNG
오행	*오행/NNG
오회	*오회/NNP
오희	*오희/NNP
옥루	*옥루/NNG
옥사	*옥사/NNG
옥쇄	*옥쇄/NNG
옥화	*옥화/NNP
온건	*온건/NNG
온난	*온난/NNG
온상	*온상/NNG
온수	*온수/NNG
온양	*온양/NNP
온오	*온오/NNG
온유	*온유/NNG
온존	*온존/NNG
온천	*온천/NNG
온축	*온축/NNG
올곡	*올곡/NNG
옴짝	*옴짝/MAG
옴쭉	*옴쭉/MAG
옴팍	*옴팍/MAG
옴팡	*옴팡/NNG
옴폭	*옴폭/MAG
옷갓	*옷갓/NNG
옹립	*옹립/NNG
옹성	*옹성/NNG
옹위	*옹위/NNG
옹폐	*옹폐/NNG
옹호	*옹호/NNG
옻칠	*옻칠/NNG
와기	*와기/NNG
와당	*와당/NNG
와류	*와류/NNG
와병	*와병/NNG
와석	*와석/NNG
와선	*와선/NNG
와싹	*와싹/MAG
와전	*와전/NNG
와짝	*와짝/MAG
와해	*와해/NNG
완간	*완간/NNG
완결	*완결/NNG
완경	*완경/NNG
완공	*완공/NNG
완구	*완구/NNG
완납	*완납/NNG
완독	*완독/NNG
완롱	*완롱/NNG
완료	*완료/NNG
완류	*완류/NNG
완벽	*완벽/NNG
완보	*완보/NNG
완부	*완부/NNG
완불	*완불/NNG
완비	*완비/NNG
완상	*완상/NNG
완석	*완석/NNG
완선	*완선/NNG
완성	*완성/NNG
완수	*완수/NNG
완숙	*완숙/NNG
완승	*완승/NNG
완악	*완악/NNG
완역	*완역/NNG
완월	*완월/NNG
완의	*완의/NNG
완장	*완장/NNG
완전	*완전/NNG
완죤	*완전/NNG
완주	*완주/NNG
완충	*완충/NNG
완치	*완치/NNG
완쾌	*완쾌/NNG
완파	*완파/NNG
완패	*완패/NNG
완행	*완행/NNG
완형	*완형/NNG
완호	*완호/NNP
완화	*완화/NNG
왈칵	*왈칵/MAG
왕가	*왕가/NNG
왕곡	*왕곡/NNP
왕관	*왕관/NNG
왕래	*왕래/NNG
왕림	*왕림/NNG
왕망	*왕망/NNP
왕복	*왕복/NNG
왕생	*왕생/NNG
왕성	*왕성/NNG
왕양	*왕양/NNG
왕왕	*왕왕/MAG
왕유	*왕유/NNP
왕일	*왕일/NNG
왕좌	*왕좌/NNG
왕진	*왕진/NNG
왕창	*왕창/MAG
왜곡	*왜곡/NNG
왜추	*왜추/NNG
왝왝	*왝왝/MAG
왱댕	*왱댕/NNG
외거	*외거/NNG
외경	*외경/NNG
외교	*외교/NNG
외근	*외근/NNG
외기	*외기/NNG
외대	*외대/NNP
외도	*외도/NNG
외면	*외면/NNG
외문	*외문/NNG
외박	*외박/NNG
외방	*외방/NNG
외복	*외복/NNG
외분	*외분/NNG
외사	*외사/NNG
외생	*외생/NNG
외설	*외설/NNG
외숙	*외숙/NNG
외시	*외시/NNG
외식	*외식/NNG
외신	*외신/NNG
외양	*외양/NNG
외연	*외연/NNG
외유	*외유/NNG
외입	*외입/NNG
외재	*외재/NNG
외적	*외적/NNG
외접	*외접/NNG
외정	*외정/NNG
외제	*외제/NNG
외주	*외주/NNG
외집	*외집/NNG
외착	*외착/NNG
외출	*외출/NNG
외치	*외치/VV
외침	*외침/NNG
외탁	*외탁/NNG
외판	*외판/NNG
외포	*외포/NNG
외항	*외항/NNG
외향	*외향/NNG
요거	*요거/NP
요격	*요격/NNG
요결	*요결/NNG
요괴	*요괴/NNG
요구	*요구/NNG
요나	*요나/NNP
요다	*요다/NNP
요담	*요담/NNG
요대	*요대/NNG
요란	*요란/NNG
요량	*요량/NNG
요러	*요러/VV
요망	*요망/NNG
요변	*요변/NNG
요부	*요부/NNG
요사	*요사/NNG
요상	*요상/NNG
요서	*요서/NNP
요설	*요설/NNG
요수	*요수/NNG
요술	*요술/NNG
요시	*요시/NNP
요악	*요악/NNG
요액	*요액/NNG
요약	*요약/NNG
요양	*요양/NNG
요역	*요역/NNG
요연	*요연/NNG
요염	*요염/NNG
요요	*요요/NNG
요절	*요절/NNG
요정	*요정/NNG
요족	*요족/NNG
요지	*요지/NNG
요철	*요철/NNG
요청	*요청/NNG
요해	*요해/NNG
요행	*요행/NNG
욕구	*욕구/NNG
욕망	*욕망/NNG
욕설	*욕설/NNG
용강	*용강/NNP
용건	*용건/NNG
용공	*용공/NNG
용구	*용구/NNG
용기	*용기/NNG
용납	*용납/NNG
용단	*용단/NNG
용달	*용달/NNG
용대	*용대/NNP
용두	*용두/NNG
용만	*용만/NNP
용맹	*용맹/NNG
용무	*용무/NNG
용법	*용법/NNG
용변	*용변/NNG
용병	*용병/NNG
용사	*용사/NNG
용상	*용상/NNG
용색	*용색/NNG
용서	*용서/NNG
용선	*용선/NNG
용세	*용세/NNG
용수	*용수/NNG
용슬	*용슬/NNG
용식	*용식/NNG
용신	*용신/NNG
용약	*용약/NNG
용연	*용연/NNG
용왕	*용왕/NNG
용용	*용용/IC
용융	*용융/NNG
용의	*용의/NNG
용일	*용일/NNG
용장	*용장/NNG
용재	*용재/NNG
용전	*용전/NNP
용접	*용접/NNG
용정	*용정/NNP
용진	*용진/NNP
용출	*용출/NNG
용타	*용타/NNP
용퇴	*용퇴/NNG
용필	*용필/NNG
용하	*용하/VA
용해	*용해/NNG
용흥	*용흥/NNP
우거	*우거/NNG
우경	*우경/NNG
우계	*우계/NNG
우고	*우고/NNP
우국	*우국/NNG
우귀	*우귀/NNG
우단	*우단/NNG
우대	*우대/NNG
우둔	*우둔/NNG
우등	*우등/NNG
우뚝	*우뚝/MAG
우량	*우량/NNG
우렁	*우렁/NNG
우려	*우려/NNG
우롱	*우롱/NNG
우림	*우림/NNG
우매	*우매/NNG
우멍	*우멍/NNG
우무	*우무/MAG
우묵	*우묵/MAG
우문	*우문/NNG
우물	*우물/NNG
우민	*우민/NNG
우박	*우박/NNG
우발	*우발/NNG
우비	*우비/NNG
우사	*우사/NNG
우상	*우상/NNG
우생	*우생/NNG
우서	*우서/NNP
우세	*우세/NNG
우송	*우송/NNG
우수	*우수/NNG
우승	*우승/NNG
우식	*우식/NNG
우애	*우애/NNG
우연	*우연/NNG
우열	*우열/NNG
우영	*우영/NNP
우완	*우완/NNG
우우	*우우/MAG
우울	*우울/NNG
우월	*우월/NNG
우유	*우유/NNG
우의	*우의/NNG
우이	*우이/IC
우일	*우일/NNG
우자	*우자/NNG
우장	*우장/NNG
우적	*우적/NNG
우전	*우전/NNG
우정	*우정/NNG
우조	*우조/NNG
우중	*우중/NNG
우쩍	*우쩍/MAG
우쭐	*우쭐/MAG
우천	*우천/NNG
우축	*우축/NNG
우치	*우치/NNG
우혹	*우혹/NNG
우화	*우화/NNG
우회	*우회/NNG
우후	*우후/NNG
욱실	*욱실/NNG
욱욱	*욱욱/MAG
운구	*운구/NNG
운동	*운동/NNG
운명	*운명/NNG
운반	*운반/NNG
운봉	*운봉/NNP
운서	*운서/NNP
운선	*운선/NNG
운송	*운송/NNG
운수	*운수/NNG
운신	*운신/NNG
운영	*운영/NNG
운용	*운용/NNG
운운	*운운/NNG
운위	*운위/NNG
운자	*운자/NNG
운전	*운전/NNG
운주	*운주/NNG
운진	*운진/NNP
운집	*운집/NNG
운치	*운치/NNG
운필	*운필/NNG
운하	*운하/NNG
운항	*운항/NNG
운행	*운행/NNG
운화	*운화/NNG
운휴	*운휴/NNG
울도	*울도/NNP
울뚝	*울뚝/MAG
울력	*울력/NNG
울릉	*울릉/NNP
울분	*울분/NNG
울산	*울산/NNP
울체	*울체/NNG
울컥	*울컥/MAG
움직	*움직/NNG
움쩍	*움쩍/MAG
움찔	*움찔/MAG
움칠	*움칠/MAG
움칫	*움칫/MAG
움푹	*움푹/MAG
웅거	*웅거/NNG
웅변	*웅변/NNG
웅비	*웅비/NNG
원격	*원격/NNG
원고	*원고/NNG
원구	*원구/NNG
원기	*원기/NNG
원념	*원념/NNG
원래	*원래/NNG
원려	*원려/NNG
원류	*원류/NNG
원망	*원망/NNG
원모	*원모/NNG
원묘	*원묘/NNP
원비	*원비/NNG
원사	*원사/NNG
원상	*원상/NNG
원색	*원색/NNG
원서	*원서/NNG
원성	*원성/NNG
원소	*원소/NNG
원시	*원시/NNG
원용	*원용/NNG
원우	*원우/NNG
원유	*원유/NNG
원융	*원융/NNG
원의	*원의/NNG
원인	*원인/NNG
원적	*원적/NNG
원전	*원전/NNG
원정	*원정/NNG
원조	*원조/NNG
원종	*원종/NNP
원죄	*원죄/NNG
원주	*원주/NNP
원차	*원차/NNG
원천	*원천/NNG
원행	*원행/NNG
원혐	*원혐/NNG
원호	*원호/NNG
원화	*원화/NNG
원활	*원활/NNG
월가	*월가/NNP
월경	*월경/NNG
월계	*월계/NNP
월권	*월권/NNG
월남	*월남/NNG
월동	*월동/NNG
월등	*월등/MAG
월명	*월명/NNP
월반	*월반/NNG
월복	*월복/NNG
월봉	*월봉/NNG
월북	*월북/NNG
월서	*월서/NNP
월성	*월성/NNP
월수	*월수/NNG
월식	*월식/NNG
월장	*월장/NNG
월차	*월차/NNG
월천	*월천/NNP
월출	*월출/NNG
월컥	*월컥/MAG
월하	*월하/NNP
웡웡	*웡웡/MAG
웩웩	*웩웩/MAG
웽웽	*웽웽/MAG
위격	*위격/NNG
위계	*위계/NNG
위구	*위구/NNG
위국	*위국/NNG
위급	*위급/NNG
위기	*위기/NNG
위락	*위락/NNG
위력	*위력/NNG
위령	*위령/NNG
위례	*위례/NNG
위무	*위무/NNG
위문	*위문/NNG
위민	*위민/NNG
위반	*위반/NNG
위배	*위배/NNG
위범	*위범/NNG
위법	*위법/NNG
위복	*위복/NNG
위산	*위산/NNG
위상	*위상/NNG
위선	*위선/NNG
위세	*위세/NNG
위수	*위수/NNG
위시	*위시/NNG
위식	*위식/NNG
위신	*위신/NNG
위악	*위악/NNG
위안	*위안/NNG
위압	*위압/NNG
위약	*위약/NNG
위양	*위양/NNG
위언	*위언/NNG
위엄	*위엄/NNG
위업	*위업/NNG
위연	*위연/NNP
위임	*위임/NNG
위자	*위자/NNG
위작	*위작/NNG
위장	*위장/NNG
위정	*위정/NNG
위조	*위조/NNG
위좌	*위좌/NNG
위중	*위중/NNG
위증	*위증/NNG
위지	*위지/NNP
위촉	*위촉/NNG
위축	*위축/NNG
위치	*위치/NNG
위칭	*위칭/NNG
위탁	*위탁/NNG
위패	*위패/NNG
위하	*위하/VV
위허	*위허/VV
위헌	*위헌/NNG
위험	*위험/NNG
위협	*위협/NNG
위호	*위호/NNG
윙윙	*윙윙/MAG
윙크	*윙크/NNG
유가	*유가/NNG
유감	*유감/NNG
유객	*유객/NNG
유격	*유격/NNG
유계	*유계/NNG
유공	*유공/NNP
유관	*유관/NNG
유괴	*유괴/NNG
유권	*유권/NNG
유급	*유급/NNG
유기	*유기/NNG
유나	*유나/NNP
유난	*유난/NNG
유년	*유년/NNG
유념	*유념/NNG
유능	*유능/NNG
유덕	*유덕/NNG
유도	*유도/NNG
유동	*유동/NNG
유락	*유락/NNG
유람	*유람/NNG
유랑	*유랑/NNG
유래	*유래/NNG
유량	*유량/NNG
유려	*유려/MAG
유력	*유력/NNG
유령	*유령/NNG
유루	*유루/NNP
유류	*유류/NNG
유린	*유린/NNG
유마	*유마/NNP
유망	*유망/NNG
유맹	*유맹/NNG
유명	*유명/NNG
유모	*유모/NNG
유목	*유목/NNG
유문	*유문/NNG
유민	*유민/NNG
유발	*유발/NNG
유방	*유방/NNG
유배	*유배/NNG
유별	*유별/NNG
유병	*유병/NNG
유보	*유보/NNG
유비	*유비/NNP
유산	*유산/NNG
유살	*유살/NNG
유상	*유상/NNG
유색	*유색/NNG
유생	*유생/NNG
유서	*유서/NNG
유성	*유성/NNG
유세	*유세/NNG
유수	*유수/NNG
유숙	*유숙/NNG
유습	*유습/NNG
유시	*유시/NNG
유식	*유식/NNG
유신	*유신/NNG
유실	*유실/NNG
유심	*유심/NNG
유아	*유아/NNG
유안	*유안/NNG
유약	*유약/NNG
유양	*유양/NNG
유언	*유언/NNG
유역	*유역/NNG
유연	*유연/NNG
유열	*유열/NNP
유영	*유영/NNG
유예	*유예/NNG
유요	*유요/NNG
유용	*유용/NNG
유우	*유우/NNG
유원	*유원/NNG
유월	*유월/NNG
유위	*유위/NNG
유음	*유음/NNG
유의	*유의/NNG
유익	*유익/NNG
유인	*유인/NNG
유일	*유일/NNG
유임	*유임/NNG
유입	*유입/NNG
유자	*유자/NNG
유장	*유장/NNG
유재	*유재/NNG
유적	*유적/NNG
유전	*유전/NNG
유정	*유정/NNG
유제	*유제/NNG
유조	*유조/NNG
유족	*유족/NNG
유종	*유종/NNG
유죄	*유죄/NNG
유지	*유지/NNG
유착	*유착/NNG
유찬	*유찬/NNP
유찰	*유찰/NNG
유체	*유체/NNG
유촉	*유촉/NNG
유추	*유추/NNG
유출	*유출/NNG
유충	*유충/NNG
유취	*유취/NNG
유치	*유치/NNG
유타	*유타/NNP
유탕	*유탕/NNG
유턴	*유턴/NNG
유통	*유통/NNG
유파	*유파/NNG
유폐	*유폐/NNG
유포	*유포/NNG
유표	*유표/NNG
유풍	*유풍/NNG
유학	*유학/NNG
유한	*유한/NNG
유합	*유합/NNP
유해	*유해/NNG
유행	*유행/NNG
유향	*유향/NNG
유현	*유현/NNG
유형	*유형/NNG
유혹	*유혹/NNG
유혼	*유혼/NNG
유화	*유화/NNG
유환	*유환/NNG
유회	*유회/NNG
유효	*유효/NNG
유흥	*유흥/NNG
유희	*유희/NNG
육각	*육각/NNG
육갑	*육갑/NNG
육교	*육교/NNG
육국	*육국/NNG
육박	*육박/NNG
육사	*육사/NNP
육서	*육서/NNG
육성	*육성/NNG
육송	*육송/NNG
육수	*육수/NNG
육시	*육시/NNG
육식	*육식/NNG
육아	*육아/NNG
육영	*육영/NNG
육정	*육정/NNG
육종	*육종/NNG
육추	*육추/NNG
육탈	*육탈/NNG
육행	*육행/NNG
윤간	*윤간/NNG
윤락	*윤락/NNG
윤문	*윤문/NNG
윤미	*윤미/NNP
윤번	*윤번/NNG
윤상	*윤상/NNP
윤색	*윤색/NNG
윤생	*윤생/NNP
윤선	*윤선/NNG
윤식	*윤식/NNP
윤작	*윤작/NNG
윤전	*윤전/NNP
윤종	*윤종/NNP
윤택	*윤택/NNG
윤하	*윤하/NNP
윤허	*윤허/NNG
윤환	*윤환/NNG
윤활	*윤활/NNG
윤회	*윤회/NNG
율기	*율기/NNG
율동	*율동/NNG
율수	*율수/NNP
융기	*융기/NNG
융성	*융성/NNG
융자	*융자/NNG
융창	*융창/NNP
융통	*융통/NNG
융합	*융합/NNG
융해	*융해/NNG
융화	*융화/NNG
융흥	*융흥/NNG
으쓱	*으쓱/MAG
윽윽	*윽윽/IC
은거	*은거/NNG
은근	*은근/NNG
은닉	*은닉/NNG
은둔	*은둔/NNG
은륜	*은륜/NNG
은미	*은미/NNP
은사	*은사/NNG
은상	*은상/NNG
은성	*은성/NNG
은수	*은수/NNG
은신	*은신/NNG
은애	*은애/NNG
은유	*은유/NNG
은인	*은인/NNG
은일	*은일/NNG
은장	*은장/NNG
은퇴	*은퇴/NNG
은폐	*은폐/NNG
은화	*은화/NNG
은휘	*은휘/NNG
음각	*음각/NNG
음결	*음결/NNG
음계	*음계/NNG
음귀	*음귀/NNG
음독	*음독/NNG
음란	*음란/NNG
음량	*음량/NNG
음매	*음매/MAG
음모	*음모/NNG
음미	*음미/NNG
음방	*음방/NNG
음보	*음보/NNG
음복	*음복/NNG
음분	*음분/NNG
음사	*음사/NNG
음소	*음소/NNG
음송	*음송/NNG
음약	*음약/NNG
음역	*음역/NNG
음영	*음영/NNG
음용	*음용/NNG
음유	*음유/NNG
음음	*음음/IC
음전	*음전/NNG
음조	*음조/NNG
음주	*음주/NNG
음풍	*음풍/NNG
음해	*음해/NNG
음행	*음행/NNG
음황	*음황/NNG
음흉	*음흉/NNG
읍례	*읍례/NNG
읍소	*읍소/NNG
읍양	*읍양/NNG
읍징	*읍징/NNG
응가	*응가/NNG
응거	*응거/NNG
응결	*응결/NNG
응고	*응고/NNG
응급	*응급/NNG
응낙	*응낙/NNG
응답	*응답/NNG
응당	*응당/MAG
응대	*응대/NNG
응명	*응명/NNG
응모	*응모/NNG
응변	*응변/NNG
응봉	*응봉/NNP
응분	*응분/NNG
응사	*응사/NNG
응석	*응석/NNG
응송	*응송/NNP
응수	*응수/NNG
응시	*응시/NNG
응아	*응아/MAG
응용	*응용/NNG
응원	*응원/NNG
응응	*응응/IC
응전	*응전/NNG
응접	*응접/NNG
응제	*응제/NNG
응집	*응집/NNG
응징	*응징/NNG
응찰	*응찰/NNG
응축	*응축/NNG
응취	*응취/NNG
응혈	*응혈/NNG
의거	*의거/NNG
의결	*의결/NNG
의경	*의경/NNG
의공	*의공/NNG
의관	*의관/NNG
의구	*의구/NNG
의궤	*의궤/NNG
의금	*의금/NNG
의기	*의기/NNG
의논	*의논/NNG
의당	*의당/MAG
의도	*의도/NNG
의례	*의례/NNG
의뢰	*의뢰/NNG
의료	*의료/NNG
의명	*의명/NNG
의문	*의문/NNG
의뭉	*의뭉/NNG
의미	*의미/NNG
의방	*의방/NNG
의법	*의법/NNG
의복	*의복/NNG
의부	*의부/NNG
의분	*의분/NNG
의비	*의비/NNP
의빙	*의빙/NNG
의사	*의사/NNG
의상	*의상/NNG
의석	*의석/NNG
의수	*의수/NNG
의식	*의식/NNG
의심	*의심/NNG
의아	*의아/NNG
의약	*의약/NNG
의역	*의역/NNG
의용	*의용/NNG
의원	*의원/NNG
의의	*의의/NNG
의이	*의이/NNG
의인	*의인/NNG
의장	*의장/NNG
의재	*의재/NNP
의적	*의적/NNG
의절	*의절/NNG
의정	*의정/NNG
의제	*의제/NNG
의존	*의존/NNG
의주	*의주/NNP
의지	*의지/NNG
의촉	*의촉/NNG
의취	*의취/NNG
의치	*의치/NNG
의타	*의타/NNG
의탁	*의탁/NNG
의태	*의태/NNG
의협	*의협/NNG
의혹	*의혹/NNG
의혼	*의혼/NNG
의회	*의회/NNG
이간	*이간/NNG
이감	*이감/NNG
이격	*이격/NNG
이경	*이경/NNG
이과	*이과/NNG
이관	*이관/NNG
이교	*이교/NNG
이구	*이구/IC
이국	*이국/NNG
이궁	*이궁/NNG
이글	*이글/NNG
이농	*이농/NNG
이뇨	*이뇨/NNG
이달	*이달/NNG
이동	*이동/NNG
이듬	*이듬/NNG
이등	*이등/NNG
이래	*이래/NNB
이러	*이러/VV
이론	*이론/NNG
이륙	*이륙/NNG
이륜	*이륜/NNG
이름	*이름/NNG
이립	*이립/NNG
이마	*이마/NNG
이목	*이목/NNG
이민	*이민/NNG
이반	*이반/NNG
이발	*이발/NNG
이별	*이별/NNG
이병	*이병/NNG
이사	*이사/NNG
이산	*이산/NNG
이상	*이상/NNG
이생	*이생/NNP
이서	*이서/NNG
이석	*이석/NNG
이선	*이선/NNP
이설	*이설/NNG
이성	*이성/NNG
이속	*이속/NNG
이송	*이송/NNG
이수	*이수/NNG
이순	*이순/NNG
이승	*이승/NNG
이식	*이식/NNG
이심	*이심/NNP
이앙	*이앙/NNG
이억	*이억/NR
이언	*이언/NNP
이역	*이역/NNG
이옥	*이옥/NNP
이완	*이완/NNG
이용	*이용/NNG
이웃	*이웃/NNG
이월	*이월/NNG
이유	*이유/NNG
이의	*이의/NNG
이임	*이임/NNG
이입	*이입/NNG
이작	*이작/NNP
이장	*이장/NNG
이재	*이재/NNG
이적	*이적/NNG
이전	*이전/NNG
이정	*이정/NNG
이종	*이종/NNG
이주	*이주/NNG
이지	*이지/NNG
이직	*이직/NNG
이차	*이차/NNG
이채	*이채/NNG
이천	*이천/NNP
이첩	*이첩/NNG
이체	*이체/NNG
이초	*이초/NNP
이취	*이취/NNG
이타	*이타/NNG
이탈	*이탈/NNG
이풍	*이풍/NNG
이합	*이합/NNG
이항	*이항/NNG
이해	*이해/NNG
이행	*이행/NNG
이향	*이향/NNG
이혼	*이혼/NNG
이화	*이화/NNG
이환	*이환/NNG
이회	*이회/NNP
익년	*익년/NNG
익명	*익명/NNG
익사	*익사/NNG
익선	*익선/NNP
익익	*익익/IC
익장	*익장/NNG
인가	*인가/NNG
인각	*인각/NNG
인간	*인간/NNG
인견	*인견/NNG
인계	*인계/NNG
인고	*인고/NNG
인공	*인공/NNG
인구	*인구/NNG
인권	*인권/NNG
인귀	*인귀/NNG
인기	*인기/NNG
인내	*인내/NNG
인덕	*인덕/NNG
인도	*인도/NNP
인륜	*인륜/NNG
인립	*인립/NNG
인면	*인면/NNG
인멸	*인멸/NNG
인명	*인명/NNG
인발	*인발/NNG
인병	*인병/NNG
인복	*인복/NNG
인부	*인부/NNG
인사	*인사/NNG
인상	*인상/NNG
인색	*인색/NNG
인석	*인석/NNG
인선	*인선/NNG
인성	*인성/NNG
인소	*인소/NNG
인솔	*인솔/NNG
인쇄	*인쇄/NNG
인수	*인수/NNG
인습	*인습/NNG
인시	*인시/NNG
인식	*인식/NNG
인신	*인신/NNG
인애	*인애/NNG
인연	*인연/NNG
인용	*인용/NNG
인유	*인유/NNG
인의	*인의/NNG
인입	*인입/NNG
인장	*인장/NNG
인접	*인접/NNG
인정	*인정/NNG
인종	*인종/NNG
인준	*인준/NNG
인증	*인증/NNG
인차	*인차/NNG
인책	*인책/NNG
인천	*인천/NNP
인출	*인출/NNG
인치	*인치/NNB
인화	*인화/NNG
일가	*일가/NNG
일각	*일각/NNG
일갈	*일갈/NNG
일거	*일거/NNG
일격	*일격/NNG
일견	*일견/NNG
일곡	*일곡/NNP
일과	*일과/NNG
일관	*일관/NNG
일괄	*일괄/NNG
일광	*일광/NNG
일구	*일구/VV
일국	*일국/NNG
일금	*일금/NNG
일기	*일기/NNG
일긴	*일긴/NNG
일독	*일독/NNG
일락	*일락/NNP
일람	*일람/NNG
일류	*일류/NNG
일망	*일망/NNG
일면	*일면/NNG
일명	*일명/NNG
일몰	*일몰/NNG
일문	*일문/NNG
일박	*일박/NNG
일벌	*일벌/NNG
일변	*일변/NNG
일별	*일별/NNG
일보	*일보/NNG
일봉	*일봉/NNG
일사	*일사/NNG
일섬	*일섬/NNG
일성	*일성/NNG
일세	*일세/NNG
일소	*일소/NNG
일숙	*일숙/NNG
일순	*일순/NNG
일식	*일식/NNG
일신	*일신/NNG
일실	*일실/NNG
일심	*일심/NNG
일안	*일안/NNG
일언	*일언/NNG
일여	*일여/NNP
일역	*일역/NNG
일용	*일용/NNG
일원	*일원/NNG
일위	*일위/NNG
일유	*일유/NNG
일정	*일정/NNG
일조	*일조/NNG
일주	*일주/NNG
일진	*일진/NNG
일착	*일착/NNG
일척	*일척/NNG
일천	*일천/NR
일철	*일철/NNG
일축	*일축/NNG
일출	*일출/NNG
일치	*일치/NNG
일탈	*일탈/NNG
일통	*일통/NNG
일행	*일행/NNG
일화	*일화/NNG
일확	*일확/NNG
일후	*일후/NNG
임검	*임검/NNG
임곡	*임곡/NNP
임관	*임관/NNG
임기	*임기/NNG
임대	*임대/NNG
임도	*임도/NNG
임립	*임립/NNG
임면	*임면/NNG
임명	*임명/NNG
임무	*임무/NNG
임문	*임문/NNG
임박	*임박/NNG
임사	*임사/NNG
임산	*임산/NNG
임상	*임상/NNG
임석	*임석/NNG
임선	*임선/NNG
임시	*임시/NNG
임신	*임신/NNG
임어	*임어/NNG
임용	*임용/NNG
임전	*임전/NNG
임종	*임종/NNG
임진	*임진/NNG
임질	*임질/NNG
임차	*임차/NNG
임천	*임천/NNG
임해	*임해/NNG
임협	*임협/NNG
임화	*임화/NNP
입각	*입각/NNG
입감	*입감/NNG
입거	*입거/NNG
입건	*입건/NNG
입격	*입격/NNG
입경	*입경/NNG
입계	*입계/NNG
입곡	*입곡/NNG
입관	*입관/NNG
입교	*입교/NNG
입구	*입구/NNG
입국	*입국/NNG
입궁	*입궁/NNG
입궐	*입궐/NNG
입금	*입금/NNG
입내	*입내/NNG
입단	*입단/NNG
입담	*입담/NNG
입당	*입당/NNG
입대	*입대/NNG
입덧	*입덧/NNG
입도	*입도/NNG
입력	*입력/NNG
입론	*입론/NNG
입마	*입마/NNG
입매	*입매/NNG
입멸	*입멸/NNG
입묘	*입묘/NNG
입무	*입무/NNG
입묵	*입묵/NNG
입문	*입문/NNG
입반	*입반/NNG
입방	*입방/NNG
입법	*입법/NNG
입북	*입북/NNG
입비	*입비/NNG
입사	*입사/NNG
입산	*입산/NNG
입상	*입상/NNG
입석	*입석/NNG
입선	*입선/NNG
입성	*입성/NNG
입소	*입소/NNG
입수	*입수/NNG
입숙	*입숙/NNG
입시	*입시/NNG
입식	*입식/NNG
입신	*입신/NNG
입실	*입실/NNG
입심	*입심/NNG
입안	*입안/NNG
입약	*입약/NNG
입양	*입양/NNG
입언	*입언/NNG
입영	*입영/NNG
입욕	*입욕/NNG
입원	*입원/NNG
입자	*입자/NNG
입장	*입장/NNG
입재	*입재/NNG
입적	*입적/NNG
입전	*입전/NNG
입점	*입점/NNG
입정	*입정/NNG
입조	*입조/NNG
입종	*입종/NNP
입주	*입주/NNG
입증	*입증/NNG
입지	*입지/NNG
입직	*입직/NNG
입짓	*입짓/NNG
입찰	*입찰/NNG
입초	*입초/NNG
입촌	*입촌/NNG
입추	*입추/NNG
입표	*입표/NNG
입학	*입학/NNG
입항	*입항/NNG
입행	*입행/NNG
입헌	*입헌/NNG
입호	*입호/NNG
입회	*입회/NNG
입후	*입후/NNG
잉잉	*잉잉/MAG
잉태	*잉태/NNG
자각	*자각/NNG
자강	*자강/NNG
자개	*자개/NNG
자격	*자격/NNG
자견	*자견/NNG
자결	*자결/NNG
자경	*자경/NNG
자계	*자계/NNG
자공	*자공/NNP
자괴	*자괴/NNG
자구	*자구/NNG
자귀	*자귀/NNG
자극	*자극/NNG
자금	*자금/NNG
자급	*자급/NNG
자긍	*자긍/NNG
자단	*자단/NNG
자담	*자담/NNG
자답	*자답/NNG
자당	*자당/NNG
자대	*자대/NNG
자득	*자득/NNG
자락	*자락/NNG
자랑	*자랑/NNG
자료	*자료/NNG
자리	*자리/NNG
자립	*자립/NNG
자릿	*자릿/NNG
자만	*자만/NNG
자매	*자매/NNG
자멸	*자멸/NNG
자모	*자모/NNG
자몽	*자몽/NNG
자문	*자문/NNG
자미	*자미/VV
자민	*자민/NNP
자박	*자박/MAG
자반	*자반/NNG
자발	*자발/NNG
자백	*자백/NNG
자변	*자변/NNG
자보	*자보/NNG
자복	*자복/NNG
자부	*자부/NNG
자분	*자분/NNG
자비	*자비/NNG
자사	*자사/NNG
자살	*자살/NNG
자상	*자상/NNG
자생	*자생/NNG
자서	*자서/NNG
자선	*자선/NNG
자성	*자성/NNG
자세	*자세/NNG
자소	*자소/NNG
자수	*자수/NNG
자숙	*자숙/NNG
자습	*자습/NNG
자승	*자승/NNG
자식	*자식/NNG
자신	*자신/NNG
자실	*자실/NNG
자안	*자안/NNG
자애	*자애/NNG
자양	*자양/NNG
자염	*자염/NNG
자영	*자영/NNG
자용	*자용/NNG
자욱	*자욱/NNG
자원	*자원/NNG
자위	*자위/NNG
자음	*자음/NNG
자인	*자인/NNG
자일	*자일/NNG
자임	*자임/NNG
자작	*자작/NNG
자장	*자장/NNG
자재	*자재/NNG
자적	*자적/NNG
자전	*자전/NNG
자절	*자절/NNG
자정	*자정/NNG
자제	*자제/NNG
자조	*자조/NNG
자족	*자족/NNG
자존	*자존/NNG
자중	*자중/NNG
자지	*자지/NNG
자진	*자진/NNG
자질	*자질/NNG
자찬	*자찬/NNG
자책	*자책/NNG
자처	*자처/NNG
자천	*자천/NNG
자청	*자청/NNG
자초	*자초/NNG
자축	*자축/NNG
자취	*자취/NNG
자치	*자치/NNG
자칫	*자칫/MAG
자칭	*자칭/NNG
자탁	*자탁/NNG
자탄	*자탄/NNG
자퇴	*자퇴/NNG
자파	*자파/NNG
자판	*자판/NNG
자평	*자평/NNG
자폐	*자폐/NNG
자포	*자포/NNG
자폭	*자폭/NNG
자필	*자필/NNG
자학	*자학/NNG
자한	*자한/NNP
자해	*자해/NNG
자행	*자행/NNG
자현	*자현/NNG
자호	*자호/NNG
자화	*자화/NNG
자활	*자활/NNG
자회	*자회/NNG
자획	*자획/NNG
자효	*자효/NNG
작가	*작가/NNG
작고	*작고/NNG
작곡	*작곡/NNG
작당	*작당/NNG
작도	*작도/NNG
작동	*작동/NNG
작두	*작두/NNG
작란	*작란/NNG
작렬	*작렬/NNG
작로	*작로/NNG
작료	*작료/NNG
작명	*작명/NNG
작목	*작목/NNG
작문	*작문/NNG
작반	*작반/NNG
작배	*작배/NNG
작법	*작법/NNG
작변	*작변/NNG
작별	*작별/NNG
작부	*작부/NNG
작사	*작사/NNG
작살	*작살/NNG
작석	*작석/NNG
작성	*작성/NNG
작시	*작시/NNG
작신	*작신/MAG
작심	*작심/NNG
작약	*작약/NNG
작업	*작업/NNG
작열	*작열/NNG
작용	*작용/NNG
작우	*작우/NNG
작작	*작작/MAG
작전	*작전/NNG
작정	*작정/NNG
작주	*작주/NNG
작태	*작태/NNG
작통	*작통/NNG
작파	*작파/NNG
작폐	*작폐/NNG
작현	*작현/NNP
작화	*작화/NNG
작흥	*작흥/NNG
작희	*작희/NNG
잔득	*잔득/MAG
잔류	*잔류/NNG
잔말	*잔말/NNG
잔망	*잔망/NNG
잔살	*잔살/NNG
잔악	*잔악/NNG
잔인	*잔인/NNG
잔일	*잔일/NNG
잔재	*잔재/NNG
잔존	*잔존/NNG
잔치	*잔치/NNG
잔파	*잔파/NNG
잔풍	*잔풍/NNG
잔학	*잔학/NNG
잔해	*잔해/NNG
잔혹	*잔혹/NNG
잘록	*잘록/MAG
잘쑥	*잘쑥/MAG
잘잘	*잘잘/MAG
잠닉	*잠닉/NNG
잠복	*잠복/NNG
잠사	*잠사/NNG
잠수	*잠수/NNG
잠식	*잠식/NNG
잠영	*잠영/NNG
잠입	*잠입/NNG
잠재	*잠재/NNG
잠적	*잠적/NNG
잠정	*잠정/NNG
잠채	*잠채/NNG
잠항	*잠항/NNG
잠행	*잠행/NNG
잡거	*잡거/NNG
잡기	*잡기/NNG
잡담	*잡담/NNG
잡답	*잡답/NNG
잡식	*잡식/NNG
잡일	*잡일/NNG
잡초	*잡초/NNG
장갑	*장갑/NNG
장개	*장개/NNG
장경	*장경/NNG
장계	*장계/NNG
장고	*장고/NNG
장관	*장관/NNG
장군	*장군/NNG
장근	*장근/MAG
장난	*장난/NNG
장남	*장남/NNG
장담	*장담/NNG
장도	*장도/NNG
장두	*장두/NNG
장락	*장락/NNP
장래	*장래/NNG
장량	*장량/NNP
장례	*장례/NNG
장류	*장류/NNG
장리	*장리/NNG
장립	*장립/NNG
장만	*장만/NNG
장면	*장면/NNG
장명	*장명/NNG
장모	*장모/NNG
장목	*장목/NNG
장문	*장문/NNG
장미	*장미/NNG
장발	*장발/NNG
장병	*장병/NNG
장복	*장복/NNG
장본	*장본/NNG
장부	*장부/NNG
장비	*장비/NNG
장사	*장사/NNG
장상	*장상/NNG
장색	*장색/NNG
장생	*장생/NNG
장서	*장서/NNG
장선	*장선/NNG
장성	*장성/NNG
장소	*장소/NNG
장송	*장송/NNG
장수	*장수/NNG
장시	*장시/NNG
장식	*장식/NNG
장신	*장신/NNG
장악	*장악/NNG
장애	*장애/NNG
장어	*장어/NNG
장엄	*장엄/NNG
장연	*장연/NNG
장우	*장우/NNP
장원	*장원/NNG
장유	*장유/NNG
장음	*장음/NNG
장의	*장의/NNG
장이	*장이/NNP
장장	*장장/MM
장재	*장재/NNG
장적	*장적/NNG
장전	*장전/NNG
장절	*장절/NNG
장점	*장점/NNG
장정	*장정/NNG
장제	*장제/NNG
장존	*장존/NNG
장졸	*장졸/NNG
장주	*장주/NNG
장진	*장진/NNP
장착	*장착/NNG
장책	*장책/NNG
장초	*장초/NNG
장치	*장치/NNG
장타	*장타/NNG
장판	*장판/NNG
장패	*장패/NNG
장폐	*장폐/NNG
장표	*장표/NNG
장하	*장하/VA
장학	*장학/NNG
장한	*장한/NNG
장해	*장해/NNG
장허	*장허/NNG
장후	*장후/NNG
장훈	*장훈/NNP
재가	*재가/NNG
재간	*재간/NNG
재갈	*재갈/NNG
재개	*재개/NNG
재거	*재거/NNG
재건	*재건/NNG
재결	*재결/NNG
재경	*재경/NNG
재계	*재계/NNG
재고	*재고/NNG
재귀	*재귀/NNG
재근	*재근/NNG
재기	*재기/NNG
재깍	*재깍/MAG
재단	*재단/NNG
재담	*재담/NNG
재독	*재독/NNG
재랄	*재랄/NNG
재래	*재래/NNG
재량	*재량/NNG
재론	*재론/NNG
재류	*재류/NNG
재림	*재림/NNG
재목	*재목/NNG
재민	*재민/NNG
재발	*재발/NNG
재방	*재방/NNG
재배	*재배/NNG
재범	*재범/NNG
재변	*재변/NNG
재병	*재병/NNG
재보	*재보/NNG
재복	*재복/NNG
재봉	*재봉/NNG
재사	*재사/NNG
재상	*재상/NNG
재생	*재생/NNG
재석	*재석/NNP
재선	*재선/NNG
재세	*재세/NNG
재소	*재소/NNG
재속	*재속/NNG
재송	*재송/NNP
재수	*재수/NNG
재식	*재식/NNP
재심	*재심/NNG
재야	*재야/NNG
재양	*재양/NNG
재언	*재언/NNG
재연	*재연/NNG
재위	*재위/NNG
재의	*재의/NNG
재인	*재인/NNG
재임	*재임/NNG
재자	*재자/NNG
재적	*재적/NNG
재정	*재정/NNG
재제	*재제/NNG
재조	*재조/NNG
재주	*재주/NNG
재직	*재직/NNG
재진	*재진/NNG
재창	*재창/NNP
재처	*재처/MAG
재천	*재천/NNG
재청	*재청/NNG
재촉	*재촉/NNG
재취	*재취/NNG
재치	*재치/NNG
재탕	*재탕/NNG
재판	*재판/NNG
재편	*재편/NNG
재학	*재학/NNG
재행	*재행/NNG
재향	*재향/NNG
재현	*재현/NNG
재혼	*재혼/NNG
재활	*재활/NNG
재회	*재회/NNG
재흥	*재흥/NNG
쟁란	*쟁란/NNG
쟁의	*쟁의/NNG
쟁쟁	*쟁쟁/MAG
쟁취	*쟁취/NNG
쟁탈	*쟁탈/NNG
쟁투	*쟁투/NNG
쟁패	*쟁패/NNG
저감	*저감/NNG
저격	*저격/NNG
저금	*저금/NNG
저급	*저급/NNG
저당	*저당/NNG
저렁	*저렁/MAG
저류	*저류/NNG
저면	*저면/NNG
저명	*저명/NNG
저미	*저미/VV
저벅	*저벅/MAG
저상	*저상/NNG
저속	*저속/NNG
저수	*저수/NNG
저술	*저술/NNG
저습	*저습/NNG
저열	*저열/NNG
저작	*저작/NNG
저장	*저장/NNG
저조	*저조/NNG
저주	*저주/NNG
저지	*저지/NNG
저촉	*저촉/NNG
저축	*저축/NNG
저치	*저치/NP
저택	*저택/NNG
저평	*저평/NNG
저하	*저하/NNG
저항	*저항/NNG
저해	*저해/NNG
저희	*저희/NP
적간	*적간/NNG
적격	*적격/NNG
적공	*적공/NNG
적구	*적구/NNG
적금	*적금/NNG
적기	*적기/NNG
적당	*적당/NNG
적대	*적대/NNG
적덕	*적덕/NNG
적록	*적록/NNG
적료	*적료/MAG
적루	*적루/NNG
적립	*적립/NNG
적막	*적막/NNG
적면	*적면/NNG
적멸	*적멸/NNG
적몰	*적몰/NNG
적발	*적발/NNG
적법	*적법/NNG
적분	*적분/NNG
적빈	*적빈/NNG
적산	*적산/NNG
적서	*적서/NNG
적선	*적선/NNG
적성	*적성/NNG
적송	*적송/NNG
적수	*적수/NNG
적신	*적신/NNG
적실	*적실/NNG
적악	*적악/NNG
적열	*적열/NNG
적요	*적요/NNG
적용	*적용/NNG
적원	*적원/NNG
적응	*적응/NNG
적장	*적장/NNG
적재	*적재/NNG
적전	*적전/NNG
적정	*적정/NNG
적조	*적조/NNG
적중	*적중/NNG
적지	*적지/NNG
적진	*적진/NNG
적체	*적체/NNG
적출	*적출/NNG
적층	*적층/NNG
적치	*적치/NNG
적토	*적토/NNG
적패	*적패/NNG
적하	*적하/NNG
적합	*적합/NNG
적화	*적화/NNG
전가	*전가/NNG
전각	*전각/NNG
전갈	*전갈/NNG
전개	*전개/NNG
전거	*전거/NNG
전게	*전게/NNG
전격	*전격/NNG
전결	*전결/NNG
전경	*전경/NNG
전계	*전계/NNG
전고	*전고/NNG
전공	*전공/NNG
전과	*전과/NNG
전관	*전관/NNG
전교	*전교/NNG
전구	*전구/NNG
전권	*전권/NNG
전근	*전근/NNG
전기	*전기/NNG
전념	*전념/NNG
전농	*전농/NNG
전능	*전능/NNG
전단	*전단/NNG
전달	*전달/NNG
전담	*전담/NNG
전당	*전당/NNG
전대	*전대/NNG
전도	*전도/NNG
전독	*전독/NNG
전동	*전동/NNG
전두	*전두/NNG
전등	*전등/NNG
전락	*전락/NNG
전래	*전래/NNG
전략	*전략/NNG
전력	*전력/NNG
전령	*전령/NNG
전루	*전루/NNG
전류	*전류/NNG
전륜	*전륜/NNG
전리	*전리/NNG
전립	*전립/NNG
전망	*전망/NNG
전매	*전매/NNG
전면	*전면/NNG
전멸	*전멸/NNG
전명	*전명/NNG
전몰	*전몰/NNG
전무	*전무/NNG
전문	*전문/NNG
전민	*전민/NNG
전박	*전박/NNG
전반	*전반/NNG
전방	*전방/NNG
전배	*전배/NNG
전법	*전법/NNG
전변	*전변/NNG
전병	*전병/NNG
전보	*전보/NNG
전복	*전복/NNG
전분	*전분/NNG
전비	*전비/NNG
전사	*전사/NNG
전상	*전상/NNG
전생	*전생/NNG
전서	*전서/NNG
전선	*전선/NNG
전설	*전설/NNG
전성	*전성/NNG
전세	*전세/NNG
전소	*전소/NNG
전속	*전속/NNG
전손	*전손/NNG
전송	*전송/NNG
전수	*전수/NNG
전술	*전술/NNG
전승	*전승/NNG
전시	*전시/NNG
전식	*전식/NNG
전신	*전신/NNG
전실	*전실/NNG
전심	*전심/NNG
전안	*전안/NNG
전약	*전약/NNG
전어	*전어/NNG
전언	*전언/NNG
전업	*전업/NNG
전역	*전역/NNG
전연	*전연/MAG
전열	*전열/NNG
전염	*전염/NNG
전와	*전와/NNG
전완	*전완/NNG
전왕	*전왕/NNG
전용	*전용/NNG
전운	*전운/NNG
전위	*전위/NNG
전유	*전유/NNG
전율	*전율/NNG
전일	*전일/NNG
전임	*전임/NNG
전입	*전입/NNG
전자	*전자/NNG
전작	*전작/NNG
전장	*전장/NNG
전재	*전재/NNG
전쟁	*전쟁/NNG
전적	*전적/NNG
전전	*전전/NNG
전정	*전정/NNG
전제	*전제/NNG
전조	*전조/NNG
전족	*전족/NNG
전중	*전중/NNG
전지	*전지/NNG
전직	*전직/NNG
전진	*전진/NNG
전질	*전질/NNG
전집	*전집/NNG
전차	*전차/NNG
전채	*전채/NNG
전철	*전철/NNG
전체	*전체/NNG
전추	*전추/NNG
전출	*전출/NNG
전취	*전취/NNG
전측	*전측/NNG
전치	*전치/NNG
전칭	*전칭/NNG
전타	*전타/NNG
전택	*전택/NNG
전통	*전통/NNG
전투	*전투/NNG
전파	*전파/NNG
전패	*전패/NNG
전편	*전편/NNG
전폐	*전폐/NNG
전포	*전포/NNG
전폭	*전폭/NNG
전학	*전학/NNG
전향	*전향/NNG
전형	*전형/NNG
전호	*전호/NNG
전화	*전화/NNG
전환	*전환/NNG
전황	*전황/NNG
전회	*전회/NNG
전횡	*전횡/NNG
전후	*전후/NNG
전희	*전희/NNG
절각	*절각/NNG
절간	*절간/NNG
절감	*절감/NNG
절강	*절강/NNP
절개	*절개/NNG
절계	*절계/NNG
절골	*절골/NNP
절교	*절교/NNG
절규	*절규/NNG
절기	*절기/NNG
절단	*절단/NNG
절략	*절략/NNG
절량	*절량/NNG
절록	*절록/NNG
절륜	*절륜/NNG
절망	*절망/NNG
절맥	*절맥/NNG
절멸	*절멸/NNG
절명	*절명/NNG
절목	*절목/NNG
절반	*절반/NNG
절분	*절분/NNG
절사	*절사/NNG
절삭	*절삭/NNG
절상	*절상/NNG
절색	*절색/NNG
절세	*절세/NNG
절손	*절손/NNG
절수	*절수/NNG
절승	*절승/NNG
절식	*절식/NNG
절신	*절신/NNG
절약	*절약/NNG
절연	*절연/NNG
절용	*절용/NNG
절의	*절의/NNG
절전	*절전/NNG
절제	*절제/NNG
절종	*절종/NNG
절주	*절주/NNG
절지	*절지/NNB
절차	*절차/NNG
절찬	*절찬/NNG
절창	*절창/NNG
절충	*절충/NNG
절취	*절취/NNG
절치	*절치/NNG
절컥	*절컥/MAG
절토	*절토/NNG
절통	*절통/NNG
절판	*절판/NNG
절필	*절필/NNG
절해	*절해/NNG
절호	*절호/NNG
절화	*절화/NNG
절후	*절후/NNG
점거	*점거/NNG
점검	*점검/NNG
점고	*점고/NNG
점다	*점다/NNG
점두	*점두/NNG
점득	*점득/NNP
점등	*점등/NNG
점령	*점령/NNG
점멸	*점멸/NNG
점묘	*점묘/NNG
점보	*점보/NNG
점복	*점복/NNG
점사	*점사/NNG
점성	*점성/NNG
점수	*점수/NNG
점안	*점안/NNG
점열	*점열/NNG
점용	*점용/NNG
점유	*점유/NNG
점적	*점적/NNG
점점	*점점/MAG
점정	*점정/NNG
점주	*점주/NNG
점증	*점증/NNG
점지	*점지/NNG
점진	*점진/NNG
점착	*점착/NNG
점철	*점철/NNG
점층	*점층/NNG
점프	*점프/NNG
점혈	*점혈/NNG
점호	*점호/NNG
점화	*점화/NNG
접객	*접객/NNG
접견	*접견/NNG
접경	*접경/NNG
접골	*접골/NNG
접구	*접구/NNG
접근	*접근/NNG
접대	*접대/NNG
접도	*접도/NNG
접맥	*접맥/NNG
접면	*접면/NNG
접목	*접목/NNG
접문	*접문/NNG
접물	*접물/NNG
접변	*접변/NNG
접사	*접사/NNG
접선	*접선/NNG
접속	*접속/NNG
접수	*접수/NNG
접신	*접신/NNG
접안	*접안/NNG
접장	*접장/NNG
접적	*접적/NNG
접전	*접전/NNG
접족	*접족/NNG
접종	*접종/NNG
접지	*접지/NNG
접착	*접착/NNG
접철	*접철/NNG
접촉	*접촉/NNG
접치	*접치/VV
접합	*접합/NNG
정가	*정가/NNG
정각	*정각/NNG
정간	*정간/NNG
정감	*정감/NNG
정강	*정강/NNG
정개	*정개/NNG
정거	*정거/NNG
정격	*정격/NNG
정결	*정결/NNG
정계	*정계/NNG
정곡	*정곡/NNG
정공	*정공/NNG
정관	*정관/NNG
정광	*정광/NNP
정구	*정구/NNG
정국	*정국/NNG
정권	*정권/NNG
정근	*정근/NNG
정금	*정금/NNG
정기	*정기/NNG
정난	*정난/NNP
정남	*정남/NNG
정납	*정납/NNG
정녕	*정녕/MAG
정담	*정담/NNG
정당	*정당/NNG
정도	*정도/NNG
정독	*정독/NNG
정돈	*정돈/NNG
정동	*정동/NNG
정란	*정란/NNP
정략	*정략/NNG
정량	*정량/NNG
정려	*정려/NNG
정련	*정련/NNG
정렬	*정렬/NNG
정례	*정례/NNG
정론	*정론/NNG
정류	*정류/NNG
정리	*정리/NNG
정립	*정립/NNG
정맥	*정맥/NNG
정명	*정명/NNG
정묘	*정묘/NNG
정무	*정무/NNG
정미	*정미/NNG
정민	*정민/NNP
정밀	*정밀/NNG
정박	*정박/NNG
정반	*정반/NNG
정방	*정방/NNG
정배	*정배/NNG
정백	*정백/NNP
정벌	*정벌/NNG
정법	*정법/NNG
정변	*정변/NNG
정복	*정복/NNG
정봉	*정봉/NNP
정부	*정부/NNG
정북	*정북/NNG
정분	*정분/NNG
정비	*정비/NNG
정사	*정사/NNG
정산	*정산/NNG
정상	*정상/NNG
정색	*정색/NNG
정생	*정생/NNG
정서	*정서/NNG
정석	*정석/NNG
정선	*정선/NNG
정성	*정성/NNG
정세	*정세/NNG
정소	*정소/NNG
정수	*정수/NNG
정순	*정순/NNP
정시	*정시/NNG
정식	*정식/NNG
정신	*정신/NNG
정실	*정실/NNG
정심	*정심/NNG
정아	*정아/NNP
정언	*정언/NNG
정역	*정역/NNG
정연	*정연/NNP
정예	*정예/NNG
정오	*정오/NNG
정외	*정외/NNG
정욕	*정욕/NNG
정우	*정우/NNP
정원	*정원/NNG
정위	*정위/NNG
정유	*정유/NNG
정육	*정육/NNG
정읍	*정읍/NNP
정의	*정의/NNG
정자	*정자/NNG
정장	*정장/NNG
정쟁	*정쟁/NNG
정적	*정적/NNG
정전	*정전/NNG
정절	*정절/NNG
정정	*정정/NNG
정제	*정제/NNG
정조	*정조/NNG
정족	*정족/NNG
정좌	*정좌/NNG
정죄	*정죄/NNG
정주	*정주/NNG
정중	*정중/NNG
정지	*정지/NNG
정직	*정직/NNG
정진	*정진/NNG
정차	*정차/NNG
정착	*정착/NNG
정찰	*정찰/NNG
정책	*정책/NNG
정철	*정철/NNP
정청	*정청/NNG
정체	*정체/NNG
정초	*정초/NNG
정축	*정축/NNG
정충	*정충/NNG
정치	*정치/NNG
정침	*정침/NNG
정타	*정타/NNG
정탐	*정탐/NNG
정태	*정태/NNG
정토	*정토/NNG
정통	*정통/NNG
정파	*정파/NNG
정패	*정패/NNG
정평	*정평/NNG
정표	*정표/NNG
정학	*정학/NNG
정합	*정합/NNG
정향	*정향/NNG
정허	*정허/VV
정현	*정현/NNP
정혼	*정혼/NNG
정화	*정화/NNG
정확	*정확/NNG
정회	*정회/NNG
정후	*정후/NNG
제각	*제각/NNG
제강	*제강/NNG
제거	*제거/NNG
제고	*제고/NNG
제곡	*제곡/NNG
제곱	*제곱/NNG
제공	*제공/NNG
제과	*제과/NNG
제관	*제관/NNG
제균	*제균/NNG
제금	*제금/NNG
제꺽	*제꺽/MAG
제당	*제당/NNG
제대	*제대/NNG
제도	*제도/NNG
제독	*제독/NNG
제동	*제동/NNG
제등	*제등/NNG
제련	*제련/NNG
제례	*제례/NNG
제론	*제론/NNP
제마	*제마/NNP
제막	*제막/NNG
제만	*제만/NNP
제면	*제면/NNG
제명	*제명/NNG
제모	*제모/NNG
제미	*제미/IC
제반	*제반/NNG
제발	*제발/MAG
제방	*제방/NNG
제배	*제배/NNG
제벌	*제벌/NNG
제보	*제보/NNG
제복	*제복/NNG
제본	*제본/NNG
제분	*제분/NNG
제빙	*제빙/NNG
제사	*제사/NNG
제살	*제살/NNG
제상	*제상/NNG
제생	*제생/NNG
제선	*제선/NNG
제설	*제설/NNG
제성	*제성/NNG
제세	*제세/NNG
제소	*제소/NNG
제수	*제수/NNG
제술	*제술/NNG
제습	*제습/NNG
제시	*제시/NNG
제악	*제악/NNG
제안	*제안/NNG
제압	*제압/NNG
제액	*제액/NNG
제약	*제약/NNG
제어	*제어/NNG
제언	*제언/NNG
제염	*제염/NNG
제영	*제영/NNG
제외	*제외/NNG
제욕	*제욕/NNG
제웅	*제웅/NNG
제의	*제의/NNG
제작	*제작/NNG
제재	*제재/NNG
제적	*제적/NNG
제절	*제절/NNG
제정	*제정/NNG
제제	*제제/NNG
제조	*제조/NNG
제족	*제족/NNG
제지	*제지/NNG
제직	*제직/NNG
제찬	*제찬/NNG
제창	*제창/NNG
제척	*제척/NNG
제철	*제철/NNG
제청	*제청/NNG
제초	*제초/NNG
제출	*제출/NNG
제치	*제치/VV
제패	*제패/NNG
제품	*제품/NNG
제한	*제한/NNG
제해	*제해/NNG
제향	*제향/NNG
제헌	*제헌/NNG
제혁	*제혁/NNG
제호	*제호/NNG
제화	*제화/NNG
제휴	*제휴/NNG
조각	*조각/NNG
조간	*조간/NNG
조갈	*조갈/NNG
조감	*조감/NNG
조강	*조강/NNG
조격	*조격/NNG
조견	*조견/NNG
조경	*조경/NNG
조고	*조고/NNG
조곡	*조곡/NNG
조공	*조공/NNG
조과	*조과/NNG
조관	*조관/NNG
조광	*조광/NNP
조교	*조교/NNG
조구	*조구/NNG
조국	*조국/NNG
조귀	*조귀/NNP
조근	*조근/NNG
조난	*조난/NNG
조단	*조단/NNP
조달	*조달/NNG
조당	*조당/NNG
조대	*조대/NNG
조도	*조도/NNG
조동	*조동/NNG
조등	*조등/NNG
조락	*조락/NNG
조력	*조력/NNG
조련	*조련/NNG
조령	*조령/NNP
조례	*조례/NNG
조로	*조로/NNG
조록	*조록/NNG
조롱	*조롱/NNG
조루	*조루/NNG
조륙	*조륙/NNG
조림	*조림/NNG
조립	*조립/NNG
조마	*조마/NNP
조망	*조망/NNG
조매	*조매/MAG
조면	*조면/NNG
조명	*조명/NNG
조묘	*조묘/NNG
조문	*조문/NNG
조미	*조미/NNG
조민	*조민/NNP
조박	*조박/NNG
조반	*조반/NNG
조발	*조발/NNG
조방	*조방/NNG
조배	*조배/NNG
조백	*조백/NNG
조복	*조복/NNG
조비	*조비/NNG
조사	*조사/NNG
조산	*조산/NNG
조삼	*조삼/NNG
조상	*조상/NNG
조색	*조색/NNG
조서	*조서/NNG
조석	*조석/NNG
조섭	*조섭/NNG
조성	*조성/NNG
조세	*조세/NNG
조소	*조소/NNG
조수	*조수/NNG
조숙	*조숙/NNG
조순	*조순/NNP
조시	*조시/NNG
조식	*조식/NNG
조신	*조신/NNG
조심	*조심/NNG
조악	*조악/NNG
조안	*조안/NNP
조애	*조애/NNP
조약	*조약/NNG
조어	*조어/NNG
조언	*조언/NNG
조업	*조업/NNG
조역	*조역/NNG
조연	*조연/NNG
조염	*조염/NNG
조영	*조영/NNG
조예	*조예/NNG
조왕	*조왕/NNG
조요	*조요/NNG
조우	*조우/NNG
조운	*조운/NNP
조원	*조원/NNG
조위	*조위/NNG
조율	*조율/NNG
조응	*조응/NNG
조의	*조의/NNG
조작	*조작/NNG
조장	*조장/NNG
조전	*조전/NNG
조절	*조절/NNG
조정	*조정/NNG
조제	*조제/NNG
조조	*조조/NNG
조졸	*조졸/NNG
조종	*조종/NNG
조주	*조주/NNG
조준	*조준/NNG
조직	*조직/NNG
조차	*조차/NNG
조찬	*조찬/NNG
조참	*조참/NNP
조처	*조처/NNG
조천	*조천/NNG
조철	*조철/NNG
조체	*조체/NNG
조출	*조출/NNG
조치	*조치/NNG
조칙	*조칙/NNG
조타	*조타/NNG
조탁	*조탁/NNG
조퇴	*조퇴/NNG
조판	*조판/NNG
조패	*조패/VV
조폐	*조폐/NNG
조포	*조포/NNG
조하	*조하/NNG
조합	*조합/NNG
조헌	*조헌/NNP
조혈	*조혈/NNG
조형	*조형/NNG
조혼	*조혼/NNG
조화	*조화/NNG
조회	*조회/NNG
조흥	*조흥/NNP
족쇄	*족쇄/NNG
족종	*족종/NNG
족징	*족징/NNG
존경	*존경/NNG
존귀	*존귀/NNG
존대	*존대/NNG
존립	*존립/NNG
존명	*존명/NNG
존모	*존모/NNG
존상	*존상/NNG
존속	*존속/NNG
존숭	*존숭/NNG
존심	*존심/NNG
존안	*존안/NNG
존엄	*존엄/NNG
존영	*존영/NNG
존재	*존재/NNG
존중	*존중/NNG
존치	*존치/NNG
존칭	*존칭/NNG
존현	*존현/NNG
졸도	*졸도/NNG
졸속	*졸속/NNG
졸업	*졸업/NNG
졸졸	*졸졸/MAG
졸지	*졸지/NNG
졸편	*졸편/NNG
종가	*종가/NNG
종간	*종간/NNG
종강	*종강/NNG
종격	*종격/NNG
종결	*종결/NNG
종경	*종경/NNG
종관	*종관/NNG
종군	*종군/NNG
종권	*종권/NNG
종기	*종기/NNG
종년	*종년/NNG
종단	*종단/NNG
종달	*종달/NNG
종량	*종량/NNG
종렬	*종렬/NNG
종례	*종례/NNG
종료	*종료/NNG
종명	*종명/NNG
종묘	*종묘/NNG
종문	*종문/NNG
종발	*종발/NNG
종방	*종방/NNG
종배	*종배/NNP
종별	*종별/NNG
종부	*종부/NNG
종사	*종사/NNG
종상	*종상/NNG
종생	*종생/NNG
종서	*종서/NNG
종성	*종성/NNP
종속	*종속/NNG
종수	*종수/NNG
종식	*종식/NNG
종신	*종신/NNG
종실	*종실/NNG
종애	*종애/NNP
종약	*종약/NNG
종양	*종양/NNG
종언	*종언/NNG
종연	*종연/NNG
종영	*종영/NNG
종요	*종요/NNG
종용	*종용/NNG
종일	*종일/NNG
종자	*종자/NNG
종장	*종장/NNG
종전	*종전/NNG
종정	*종정/NNG
종제	*종제/NNG
종종	*종종/MAG
종주	*종주/NNG
종중	*종중/NNG
종지	*종지/NNG
종질	*종질/NNG
종착	*종착/NNG
종추	*종추/NNG
종파	*종파/NNG
종풍	*종풍/NNG
종합	*종합/NNG
종헌	*종헌/NNG
종환	*종환/NNG
종회	*종회/NNG
종횡	*종횡/NNG
좌경	*좌경/NNG
좌고	*좌고/NNG
좌골	*좌골/NNG
좌기	*좌기/NNG
좌단	*좌단/NNG
좌담	*좌담/NNG
좌상	*좌상/NNG
좌선	*좌선/NNG
좌수	*좌수/NNG
좌시	*좌시/NNG
좌식	*좌식/NNG
좌우	*좌우/NNG
좌절	*좌절/NNG
좌정	*좌정/NNG
좌창	*좌창/NNG
좌천	*좌천/NNG
좌초	*좌초/NNG
좍좍	*좍좍/MAG
좔좔	*좔좔/MAG
죄과	*죄과/NNG
죄범	*죄범/NNG
주가	*주가/NNG
주거	*주거/NNG
주경	*주경/NNG
주공	*주공/NNG
주관	*주관/NNG
주구	*주구/NNG
주급	*주급/NNG
주달	*주달/NNG
주도	*주도/NNG
주독	*주독/NNG
주동	*주동/NNG
주둔	*주둔/NNG
주력	*주력/NNG
주련	*주련/NNG
주례	*주례/NNG
주룩	*주룩/MAG
주류	*주류/NNG
주림	*주림/NNG
주마	*주마/NNG
주말	*주말/NNG
주모	*주모/NNG
주목	*주목/NNG
주무	*주무/NNG
주문	*주문/NNG
주방	*주방/NNG
주번	*주번/NNG
주벽	*주벽/NNG
주변	*주변/NNG
주병	*주병/NNG
주보	*주보/NNG
주부	*주부/NNG
주삣	*주삣/MAG
주사	*주사/NNG
주산	*주산/NNG
주상	*주상/NNG
주서	*주서/NNP
주석	*주석/NNG
주선	*주선/NNG
주소	*주소/NNG
주수	*주수/NNG
주시	*주시/NNG
주식	*주식/NNG
주악	*주악/NNG
주안	*주안/NNG
주앙	*주앙/NNP
주업	*주업/NNG
주역	*주역/NNG
주연	*주연/NNG
주우	*주우/NNG
주유	*주유/NNG
주의	*주의/NNG
주임	*주임/NNG
주입	*주입/NNG
주작	*주작/NNG
주장	*주장/NNG
주재	*주재/NNG
주저	*주저/NNG
주적	*주적/NNG
주전	*주전/NNG
주점	*주점/NNG
주접	*주접/NNG
주정	*주정/NNG
주제	*주제/NNG
주조	*주조/NNG
주종	*주종/NNG
주좌	*주좌/NNG
주진	*주진/NNP
주차	*주차/NNG
주착	*주착/NNG
주찬	*주찬/NNG
주찰	*주찰/NNG
주창	*주창/NNG
주책	*주책/NNG
주청	*주청/NNG
주체	*주체/NNG
주초	*주초/NNG
주최	*주최/NNG
주춤	*주춤/MAG
주파	*주파/NNG
주판	*주판/NNG
주필	*주필/NNG
주하	*주하/NNP
주항	*주항/NNG
주해	*주해/NNG
주행	*주행/NNG
주향	*주향/NNG
주화	*주화/NNG
주황	*주황/NNG
주회	*주회/NNG
주효	*주효/NNG
준가	*준가/NNG
준결	*준결/NNG
준공	*준공/NNG
준동	*준동/NNG
준례	*준례/NNG
준법	*준법/NNG
준별	*준별/NNG
준봉	*준봉/NNG
준비	*준비/NNG
준설	*준설/NNG
준순	*준순/NNG
준시	*준시/NNG
준용	*준용/NNG
준장	*준장/NNG
준총	*준총/NNG
준치	*준치/NNG
준행	*준행/NNG
줄줄	*줄줄/MAG
중간	*중간/NNG
중개	*중개/NNG
중건	*중건/NNG
중경	*중경/NNP
중계	*중계/NNG
중과	*중과/NNG
중구	*중구/NNP
중년	*중년/NNG
중단	*중단/NNG
중독	*중독/NNG
중략	*중략/NNG
중립	*중립/NNG
중매	*중매/NNG
중명	*중명/NNG
중벌	*중벌/NNG
중범	*중범/NNG
중복	*중복/NNG
중사	*중사/NNG
중상	*중상/NNG
중생	*중생/NNG
중선	*중선/NNG
중수	*중수/NNG
중시	*중시/NNG
중식	*중식/NNG
중신	*중신/NNG
중심	*중심/NNG
중악	*중악/NNP
중압	*중압/NNG
중역	*중역/NNG
중요	*중요/NNG
중용	*중용/NNG
중위	*중위/NNG
중장	*중장/NNG
중재	*중재/NNG
중절	*중절/NNG
중정	*중정/NNG
중조	*중조/NNG
중주	*중주/NNG
중중	*중중/NNG
중지	*중지/NNG
중창	*중창/NNG
중책	*중책/NNG
중첩	*중첩/NNG
중초	*중초/NNG
중추	*중추/NNG
중축	*중축/NNG
중치	*중치/NNG
중탕	*중탕/NNG
중퇴	*중퇴/NNG
중파	*중파/NNG
중판	*중판/NNG
중합	*중합/NNG
중혼	*중혼/NNG
중화	*중화/NNG
중환	*중환/NNG
중흥	*중흥/NNG
즈음	*즈음/NNB
즉결	*즉결/NNG
즉답	*즉답/NNG
즉발	*즉발/NNG
즉사	*즉사/NNG
즉살	*즉살/NNG
즉위	*즉위/NNG
증가	*증가/NNG
증감	*증감/NNG
증강	*증강/NNG
증구	*증구/NNG
증기	*증기/NNG
증답	*증답/NNG
증대	*증대/NNG
증득	*증득/NNG
증량	*증량/NNG
증류	*증류/NNG
증면	*증면/NNG
증명	*증명/NNG
증발	*증발/NNG
증병	*증병/NNG
증보	*증보/NNG
증빙	*증빙/NNG
증산	*증산/NNG
증상	*증상/NNG
증설	*증설/NNG
증세	*증세/NNG
증손	*증손/NNG
증수	*증수/NNG
증시	*증시/NNG
증식	*증식/NNG
증액	*증액/NNG
증언	*증언/NNG
증여	*증여/NNG
증오	*증오/NNG
증원	*증원/NNG
증유	*증유/NNG
증인	*증인/NNG
증자	*증자/NNG
증장	*증장/NNG
증정	*증정/NNG
증증	*증증/NNG
증진	*증진/NNG
증차	*증차/NNG
증축	*증축/NNG
증치	*증치/NNG
증파	*증파/NNG
증편	*증편/NNG
증폭	*증폭/NNG
증험	*증험/NNG
지각	*지각/NNG
지갈	*지갈/NNG
지계	*지계/NNG
지공	*지공/NNG
지교	*지교/NNG
지구	*지구/NNG
지궁	*지궁/NNG
지귀	*지귀/NNP
지근	*지근/NNG
지급	*지급/NNG
지기	*지기/NNG
지끈	*지끈/MAG
지끔	*지끔/MAG
지남	*지남/NNG
지당	*지당/NNG
지대	*지대/NNG
지도	*지도/NNG
지동	*지동/NNG
지랄	*지랄/NNG
지럴	*지럴/NNG
지려	*지려/MAG
지령	*지령/NNG
지망	*지망/NNG
지매	*지매/NNG
지면	*지면/NNG
지명	*지명/NNG
지모	*지모/NNG
지목	*지목/NNG
지밀	*지밀/NNG
지발	*지발/MAG
지방	*지방/NNG
지배	*지배/NNG
지번	*지번/NNG
지변	*지변/NNG
지보	*지보/NNG
지복	*지복/NNG
지부	*지부/NNG
지분	*지분/NNG
지불	*지불/NNG
지사	*지사/NNG
지상	*지상/NNG
지선	*지선/NNG
지성	*지성/NNG
지세	*지세/NNG
지소	*지소/NNG
지속	*지속/NNG
지수	*지수/NNG
지숙	*지숙/NNP
지시	*지시/NNG
지식	*지식/NNG
지신	*지신/NNG
지실	*지실/NNG
지심	*지심/NNG
지악	*지악/NNG
지압	*지압/NNG
지양	*지양/NNG
지연	*지연/NNG
지열	*지열/NNG
지원	*지원/NNG
지위	*지위/NNG
지율	*지율/NNP
지음	*지음/NNG
지장	*지장/NNG
지재	*지재/NNG
지적	*지적/NNG
지절	*지절/NNG
지점	*지점/NNG
지정	*지정/NNG
지조	*지조/NNG
지존	*지존/NNG
지주	*지주/NNG
지중	*지중/NNG
지짐	*지짐/NNG
지참	*지참/NNG
지척	*지척/NNG
지천	*지천/NNG
지체	*지체/NNG
지출	*지출/NNG
지칭	*지칭/NNG
지탄	*지탄/NNG
지탱	*지탱/NNG
지통	*지통/NNG
지평	*지평/NNG
지학	*지학/NNG
지한	*지한/NNG
지행	*지행/NNG
지향	*지향/NNG
지혈	*지혈/NNG
지회	*지회/NNG
지휘	*지휘/NNG
직각	*직각/NNG
직간	*직간/NNG
직감	*직감/NNG
직격	*직격/NNG
직결	*직결/NNG
직경	*직경/NNG
직계	*직계/NNG
직관	*직관/NNG
직교	*직교/NNG
직립	*직립/NNG
직면	*직면/NNG
직배	*직배/NNG
직보	*직보/NNG
직사	*직사/NNG
직서	*직서/NNG
직선	*직선/NNG
직설	*직설/NNG
직소	*직소/NNG
직속	*직속/NNG
직송	*직송/NNG
직시	*직시/NNG
직언	*직언/NNG
직역	*직역/NNG
직영	*직영/NNG
직임	*직임/NNG
직입	*직입/NNG
직절	*직절/NNG
직조	*직조/NNG
직직	*직직/MAG
직진	*직진/NNG
직토	*직토/NNG
직통	*직통/NNG
직파	*직파/NNG
직판	*직판/NNG
직품	*직품/NNG
직필	*직필/NNG
직핍	*직핍/NNG
직할	*직할/NNG
직항	*직항/NNG
직해	*직해/NNG
직행	*직행/NNG
진거	*진거/NNG
진격	*진격/NNG
진경	*진경/NNG
진공	*진공/NNG
진구	*진구/NNP
진국	*진국/NNG
진군	*진군/NNG
진궁	*진궁/NNP
진급	*진급/NNG
진념	*진념/NNG
진노	*진노/NNG
진다	*진다/NNG
진단	*진단/NNG
진담	*진담/NNG
진도	*진도/NNG
진동	*진동/NNG
진력	*진력/NNG
진맥	*진맥/NNG
진명	*진명/NNP
진무	*진무/NNP
진배	*진배/NNG
진보	*진보/NNG
진봉	*진봉/NNP
진사	*진사/NNG
진상	*진상/NNG
진서	*진서/NNG
진설	*진설/NNG
진성	*진성/NNG
진송	*진송/NNG
진수	*진수/NNG
진술	*진술/NNG
진시	*진시/NNG
진실	*진실/NNG
진압	*진압/NNG
진어	*진어/NNG
진언	*진언/NNG
진열	*진열/NNG
진운	*진운/NNG
진원	*진원/NNG
진위	*진위/NNG
진유	*진유/NNG
진육	*진육/NNG
진이	*진이/NNP
진일	*진일/NNG
진입	*진입/NNG
진장	*진장/NNG
진적	*진적/NNG
진전	*진전/NNG
진주	*진주/NNG
진중	*진중/NNG
진지	*진지/NNG
진질	*진질/NNG
진찰	*진찰/NNG
진척	*진척/NNG
진천	*진천/NNP
진출	*진출/NNG
진취	*진취/NNG
진탁	*진탁/NNG
진통	*진통/NNG
진퇴	*진퇴/NNG
진학	*진학/NNG
진항	*진항/NNP
진행	*진행/NNG
진향	*진향/NNG
진혼	*진혼/NNG
진화	*진화/NNG
진환	*진환/NNP
진황	*진황/NNG
진휼	*진휼/NNG
진흥	*진흥/NNG
진희	*진희/NNP
질겁	*질겁/NNG
질고	*질고/NNG
질구	*질구/NNG
질근	*질근/MAG
질기	*질기/VA
질대	*질대/NNG
질문	*질문/NNG
질색	*질색/NNG
질소	*질소/NNG
질시	*질시/NNG
질식	*질식/NNG
질의	*질의/NNG
질정	*질정/NNG
질주	*질주/NNG
질질	*질질/MAG
질책	*질책/NNG
질청	*질청/NNG
질타	*질타/NNG
질탕	*질탕/NNG
질투	*질투/NNG
질화	*질화/NNG
짐작	*짐작/NNG
짐짓	*짐짓/MAG
집거	*집거/NNG
집결	*집결/NNG
집계	*집계/NNG
집광	*집광/NNG
집권	*집권/NNG
집념	*집념/NNG
집맥	*집맥/NNG
집무	*집무/NNG
집산	*집산/NNG
집성	*집성/NNG
집수	*집수/NNG
집시	*집시/NNG
집약	*집약/NNG
집작	*집작/NNG
집장	*집장/NNG
집적	*집적/NNG
집전	*집전/NNG
집정	*집정/NNG
집중	*집중/NNG
집지	*집지/NNG
집진	*집진/NNG
집착	*집착/NNG
집찰	*집찰/NNG
집총	*집총/NNG
집편	*집편/NNG
집표	*집표/NNG
집필	*집필/NNG
집하	*집하/NNG
집합	*집합/NNG
집행	*집행/NNG
집회	*집회/NNG
징계	*징계/NNG
징구	*징구/NNG
징모	*징모/NNG
징발	*징발/NNG
징벌	*징벌/NNG
징병	*징병/NNG
징세	*징세/NNG
징수	*징수/NNG
징용	*징용/NNG
징집	*징집/NNG
징징	*징징/MAG
징치	*징치/NNG
징험	*징험/NNG
짝짝	*짝짝/MAG
짤깍	*짤깍/MAG
짤랑	*짤랑/MAG
짤록	*짤록/MAG
짤짤	*짤짤/MAG
짬뽕	*짬뽕/NNG
짭짭	*짭짭/MAG
짱짱	*짱짱/MAG
째깍	*째깍/MAG
짹짹	*짹짹/MAG
쨍쨍	*쨍쨍/MAG
쩌렁	*쩌렁/MAG
쩍쩍	*쩍쩍/MAG
쩔겅	*쩔겅/MAG
쩔렁	*쩔렁/MAG
쩔룩	*쩔룩/MAG
쩔쩔	*쩔쩔/MAG
쩝쩝	*쩝쩝/MAG
쩟쩟	*쩟쩟/IC
쩡쩡	*쩡쩡/MAG
쪽쪽	*쪽쪽/MAG
쫄쫄	*쫄쫄/MAG
쫑긋	*쫑긋/MAG
쫙쫙	*쫙쫙/MAG
쭈빗	*쭈빗/MAG
쭈뼛	*쭈뼛/MAG
쭉쭉	*쭉쭉/MAG
쭐쭐	*쭐쭐/MAG
쯧쯧	*쯧쯧/MAG
찌릿	*찌릿/MAG
찍찍	*찍찍/MAG
찔끔	*찔끔/MAG
찔찔	*찔찔/MAG
찜질	*찜질/NNG
찡긋	*찡긋/MAG
찡찡	*찡찡/MAG
차감	*차감/NNG
차관	*차관/NNG
차광	*차광/NNG
차근	*차근/MAG
차단	*차단/NNG
차등	*차등/NNG
차량	*차량/NNG
차력	*차력/NNG
차명	*차명/NNG
차미	*차미/NNG
차별	*차별/NNG
차비	*차비/NNG
차상	*차상/NNG
차석	*차석/NNG
차수	*차수/NNG
차악	*차악/NNG
차양	*차양/NNG
차용	*차용/NNG
차위	*차위/NNG
차음	*차음/NNG
차임	*차임/NNG
차입	*차입/NNG
차자	*차자/NNG
차작	*차작/NNG
차장	*차장/NNG
차점	*차점/NNG
차제	*차제/NNG
차질	*차질/NNG
차차	*차차/MAG
차출	*차출/NNG
차치	*차치/NNG
차태	*차태/NNG
차폐	*차폐/NNG
차하	*차하/NNG
차함	*차함/NNG
차환	*차환/NNG
착가	*착가/NNG
착각	*착각/NNG
착공	*착공/NNG
착관	*착관/NNG
착근	*착근/NNG
착란	*착란/NNG
착륙	*착륙/NNG
착명	*착명/NNG
착목	*착목/NNG
착복	*착복/NNG
착상	*착상/NNG
착색	*착색/NNG
착석	*착석/NNG
착수	*착수/NNG
착시	*착시/NNG
착신	*착신/NNG
착심	*착심/NNG
착안	*착안/NNG
착어	*착어/NNG
착오	*착오/NNG
착용	*착용/NNG
착유	*착유/NNG
착의	*착의/NNG
착인	*착인/NNP
착임	*착임/NNG
착종	*착종/NNG
착즙	*착즙/NNG
착지	*착지/NNG
착착	*착착/MAG
착취	*착취/NNG
착하	*착하/VA
찬결	*찬결/NNP
찬구	*찬구/NNP
찬동	*찬동/NNG
찬미	*찬미/NNG
찬배	*찬배/NNG
찬사	*찬사/NNG
찬성	*찬성/NNG
찬송	*찬송/NNG
찬술	*찬술/NNG
찬시	*찬시/NNG
찬양	*찬양/NNG
찬자	*찬자/NNG
찬작	*찬작/NNG
찬조	*찬조/NNG
찬탁	*찬탁/NNG
찬탄	*찬탄/NNG
찬탈	*찬탈/NNG
찬하	*찬하/VV
찰기	*찰기/NNG
찰깍	*찰깍/MAG
찰랑	*찰랑/MAG
찰박	*찰박/MAG
찰방	*찰방/NNG
찰색	*찰색/NNG
찰싹	*찰싹/MAG
찰주	*찰주/NNG
찰지	*찰지/VA
찰찰	*찰찰/MAG
찰칵	*찰칵/MAG
참가	*참가/NNG
참견	*참견/NNG
참관	*참관/NNG
참구	*참구/NNG
참군	*참군/NNG
참내	*참내/IC
참담	*참담/NNG
참례	*참례/NNG
참모	*참모/NNG
참배	*참배/NNG
참사	*참사/NNG
참살	*참살/NNG
참상	*참상/NNG
참서	*참서/NNG
참석	*참석/NNG
참선	*참선/NNG
참섭	*참섭/NNG
참세	*참세/NNG
참소	*참소/NNG
참수	*참수/NNG
참알	*참알/NNG
참여	*참여/NNG
참역	*참역/NNG
참예	*참예/NNG
참위	*참위/NNG
참작	*참작/NNG
참전	*참전/NNG
참정	*참정/NNG
참제	*참제/NNG
참조	*참조/NNG
참주	*참주/NNG
참척	*참척/NNG
참천	*참천/NNG
참치	*참치/NNG
참칭	*참칭/NNG
참패	*참패/NNG
참하	*참하/VA
참해	*참해/NNG
참형	*참형/NNG
참호	*참호/NNG
참혹	*참혹/NNG
참회	*참회/NNG
참획	*참획/NNG
창가	*창가/NNG
창간	*창간/NNG
창건	*창건/NNG
창고	*창고/NNG
창공	*창공/NNG
창군	*창군/NNG
창궐	*창궐/NNG
창기	*창기/NNG
창단	*창단/NNG
창달	*창달/NNG
창당	*창당/NNG
창대	*창대/NNG
창덕	*창덕/NNP
창도	*창도/NNG
창립	*창립/NNG
창방	*창방/NNG
창사	*창사/NNG
창선	*창선/NNP
창설	*창설/NNG
창성	*창성/NNG
창세	*창세/NNG
창시	*창시/NNG
창안	*창안/NNG
창업	*창업/NNG
창원	*창원/NNP
창의	*창의/NNG
창작	*창작/NNG
창제	*창제/NNG
창조	*창조/NNG
창천	*창천/NNG
창촉	*창촉/NNG
창출	*창출/NNG
창평	*창평/NNP
창피	*창피/NNG
창호	*창호/NNG
창황	*창황/NNG
채광	*채광/NNG
채굴	*채굴/NNG
채근	*채근/NNG
채금	*채금/NNG
채납	*채납/NNG
채득	*채득/NNG
채록	*채록/NNG
채밀	*채밀/NNG
채변	*채변/NNG
채보	*채보/NNG
채비	*채비/NNG
채산	*채산/NNG
채색	*채색/NNG
채석	*채석/NNG
채수	*채수/NNG
채식	*채식/NNG
채용	*채용/NNG
채유	*채유/NNG
채점	*채점/NNG
채종	*채종/NNG
채집	*채집/NNG
채취	*채취/NNG
채탄	*채탄/NNG
채택	*채택/NNG
채혈	*채혈/NNG
채화	*채화/NNG
책동	*책동/NNG
책망	*책망/NNG
책명	*책명/NNG
책벌	*책벌/NNG
책보	*책보/NNG
책봉	*책봉/NNG
책비	*책비/NNG
책성	*책성/NNG
책정	*책정/NNG
처결	*처결/NNG
처단	*처단/NNG
처리	*처리/NNG
처벌	*처벌/NNG
처분	*처분/NNG
처사	*처사/NNG
처세	*처세/NNG
처신	*처신/NNG
처우	*처우/NNG
처절	*처절/NNG
처처	*처처/NNG
처치	*처치/NNG
처형	*처형/NNG
척간	*척간/NNG
척결	*척결/NNG
척구	*척구/NNG
척량	*척량/NNG
척매	*척매/NNG
척불	*척불/NNG
척사	*척사/NNG
척살	*척살/NNG
척애	*척애/NNG
척양	*척양/NNG
척왜	*척왜/NNG
척전	*척전/NNG
척제	*척제/NNG
척지	*척지/VV
척척	*척척/MAG
척화	*척화/NNG
천거	*천거/NNG
천경	*천경/NNP
천공	*천공/NNG
천관	*천관/NNG
천구	*천구/NNG
천극	*천극/NNG
천금	*천금/NNG
천기	*천기/NNG
천년	*천년/NNG
천단	*천단/NNG
천대	*천대/NNG
천도	*천도/NNG
천둥	*천둥/NNG
천락	*천락/NNG
천람	*천람/NNG
천려	*천려/NNG
천렵	*천렵/NNG
천령	*천령/NNG
천명	*천명/NNG
천문	*천문/NNG
천박	*천박/NNG
천변	*천변/NNG
천봉	*천봉/NNG
천부	*천부/NNG
천불	*천불/NNG
천비	*천비/NNG
천사	*천사/NNG
천성	*천성/NNG
천수	*천수/NNG
천시	*천시/NNG
천식	*천식/NNG
천신	*천신/NNG
천양	*천양/NNG
천역	*천역/NNG
천연	*천연/NNG
천예	*천예/NNG
천의	*천의/NNG
천이	*천이/NNG
천인	*천인/NNG
천자	*천자/NNG
천작	*천작/NNG
천장	*천장/NNG
천재	*천재/NNG
천적	*천적/NNG
천전	*천전/NNP
천정	*천정/NNG
천주	*천주/NNP
천직	*천직/NNG
천진	*천진/NNG
천착	*천착/NNG
천체	*천체/NNG
천초	*천초/NNG
천추	*천추/NNG
천측	*천측/NNG
천침	*천침/NNG
천칭	*천칭/NNG
천편	*천편/NNG
천행	*천행/NNG
천험	*천험/NNG
천회	*천회/NNG
철각	*철각/NNG
철거	*철거/NNG
철골	*철골/NNG
철군	*철군/NNG
철기	*철기/NNG
철렁	*철렁/MAG
철벅	*철벅/MAG
철벙	*철벙/MAG
철병	*철병/NNG
철사	*철사/NNG
철상	*철상/NNG
철선	*철선/NNG
철수	*철수/NNG
철시	*철시/NNG
철썩	*철썩/MAG
철야	*철야/NNG
철자	*철자/NNG
철저	*철저/NNG
철전	*철전/NNG
철제	*철제/NNG
철조	*철조/NNG
철주	*철주/NNG
철컥	*철컥/MAG
철컹	*철컹/MAG
철퇴	*철퇴/NNG
철폐	*철폐/NNG
철포	*철포/NNG
철환	*철환/NNP
철회	*철회/NNG
첨가	*첨가/NNG
첨례	*첨례/NNG
첨벙	*첨벙/MAG
첨병	*첨병/NNG
첨부	*첨부/NNG
첨사	*첨사/NNG
첨삭	*첨삭/NNG
첨언	*첨언/NNG
첨작	*첨작/NNG
첨잔	*첨잔/NNG
첨치	*첨치/NNG
첩경	*첩경/NNG
첩리	*첩리/NNG
첩보	*첩보/NNG
첩부	*첩부/NNG
첩지	*첩지/NNG
첩첩	*첩첩/MAG
청강	*청강/NNG
청결	*청결/NNG
청경	*청경/NNG
청구	*청구/NNG
청단	*청단/NNG
청담	*청담/NNP
청도	*청도/NNP
청력	*청력/NNG
청렴	*청렴/NNG
청리	*청리/NNP
청매	*청매/NNG
청명	*청명/NNG
청문	*청문/NNG
청배	*청배/NNG
청백	*청백/NNG
청부	*청부/NNG
청빈	*청빈/NNG
청빙	*청빙/NNG
청사	*청사/NNG
청산	*청산/NNG
청상	*청상/NNG
청서	*청서/NNG
청소	*청소/NNG
청송	*청송/NNG
청수	*청수/NNG
청순	*청순/NNG
청약	*청약/NNG
청연	*청연/NNG
청염	*청염/NNG
청용	*청용/NNG
청우	*청우/NNG
청원	*청원/NNG
청유	*청유/NNG
청의	*청의/NNG
청인	*청인/NNG
청장	*청장/NNG
청전	*청전/NNG
청절	*청절/NNG
청정	*청정/NNG
청조	*청조/NNG
청직	*청직/NNG
청진	*청진/NNP
청천	*청천/NNG
청촉	*청촉/NNG
청취	*청취/NNG
청탁	*청탁/NNG
청평	*청평/NNP
청허	*청허/VV
청호	*청호/NNP
청혼	*청혼/NNG
청화	*청화/NNP
청훈	*청훈/NNG
체감	*체감/NNG
체결	*체결/NNG
체경	*체경/NNG
체계	*체계/NNG
체공	*체공/NNG
체관	*체관/NNG
체교	*체교/NNG
체구	*체구/NNG
체급	*체급/NNG
체납	*체납/NNG
체념	*체념/NNG
체득	*체득/NNG
체류	*체류/NNG
체면	*체면/NNG
체벌	*체벌/NNG
체불	*체불/NNG
체색	*체색/NNG
체선	*체선/NNG
체인	*체인/NNG
체임	*체임/NNG
체재	*체재/NNG
체전	*체전/NNG
체조	*체조/NNG
체중	*체중/NNG
체증	*체증/NNG
체질	*체질/NNG
체천	*체천/NNG
체크	*체크/NNG
체포	*체포/NNG
체하	*체하/VV
체한	*체한/NNG
체향	*체향/NNG
체험	*체험/NNG
체현	*체현/NNG
체형	*체형/NNG
체화	*체화/NNG
초각	*초각/NNG
초검	*초검/NNG
초격	*초격/NNG
초경	*초경/NNG
초계	*초계/NNG
초과	*초과/NNG
초군	*초군/NNG
초극	*초극/NNG
초급	*초급/NNG
초기	*초기/NNG
초달	*초달/NNG
초대	*초대/NNG
초등	*초등/NNG
초래	*초래/NNG
초려	*초려/NNG
초례	*초례/NNG
초로	*초로/NNG
초록	*초록/NNG
초립	*초립/NNG
초모	*초모/NNG
초미	*초미/NNG
초범	*초범/NNG
초벽	*초벽/NNG
초복	*초복/NNG
초빈	*초빈/NNG
초빙	*초빙/NNG
초사	*초사/NNG
초산	*초산/NNG
초서	*초서/NNG
초선	*초선/NNG
초설	*초설/NNG
초속	*초속/NNG
초순	*초순/NNG
초승	*초승/NNG
초식	*초식/NNG
초심	*초심/NNG
초안	*초안/NNG
초역	*초역/NNG
초연	*초연/NNG
초오	*초오/NNG
초우	*초우/NNG
초원	*초원/NNG
초월	*초월/NNG
초유	*초유/NNG
초인	*초인/NNG
초임	*초임/NNG
초입	*초입/NNG
초자	*초자/NNG
초장	*초장/NNG
초절	*초절/NNG
초점	*초점/NNG
초제	*초제/NNG
초조	*초조/NNG
초지	*초지/NNG
초진	*초진/NNG
초창	*초창/NNG
초청	*초청/NNG
초초	*초초/NNG
초치	*초치/NNG
초침	*초침/NNG
초탈	*초탈/NNG
초토	*초토/NNG
초풍	*초풍/NNG
초학	*초학/NNG
초행	*초행/NNG
초헌	*초헌/NNG
초혼	*초혼/NNG
초화	*초화/NNG
촉감	*촉감/NNG
촉구	*촉구/NNG
촉급	*촉급/NNG
촉망	*촉망/NNG
촉박	*촉박/NNG
촉발	*촉발/NNG
촉산	*촉산/NNG
촉성	*촉성/NNG
촉수	*촉수/NNG
촉진	*촉진/NNG
촉탁	*촉탁/NNG
촌탁	*촌탁/NNG
촌평	*촌평/NNG
촘촘	*촘촘/MAG
총격	*총격/NNG
총계	*총계/NNG
총고	*총고/NNG
총괄	*총괄/NNG
총기	*총기/NNG
총람	*총람/NNG
총령	*총령/NNG
총리	*총리/NNG
총명	*총명/NNG
총사	*총사/NNG
총살	*총살/NNG
총생	*총생/NNG
총신	*총신/NNG
총애	*총애/NNG
총재	*총재/NNG
총찰	*총찰/NNG
총총	*총총/MAG
총칭	*총칭/NNG
총통	*총통/NNG
총판	*총판/NNG
총합	*총합/NNG
총회	*총회/NNG
촬영	*촬영/NNG
최고	*최고/NNG
최귀	*최귀/NNG
최급	*최급/NNG
최다	*최다/NNG
최단	*최단/NNG
최대	*최대/NNG
최량	*최량/NNG
최루	*최루/NNG
최소	*최소/NNG
최장	*최장/NNG
최저	*최저/NNG
최적	*최적/NNG
최호	*최호/NNP
최환	*최환/NNP
추가	*추가/NNG
추간	*추간/NNG
추격	*추격/NNG
추경	*추경/NNG
추계	*추계/NNG
추곡	*추곡/NNG
추관	*추관/NNG
추구	*추구/NNG
추국	*추국/NNG
추궁	*추궁/NNG
추급	*추급/NNG
추념	*추념/NNG
추노	*추노/NNG
추단	*추단/NNG
추대	*추대/NNG
추도	*추도/NNG
추돌	*추돌/NNG
추동	*추동/NNG
추락	*추락/NNG
추렴	*추렴/NNG
추론	*추론/NNG
추모	*추모/NNG
추문	*추문/NNG
추방	*추방/NNG
추비	*추비/NNG
추사	*추사/NNP
추산	*추산/NNG
추상	*추상/NNG
추서	*추서/NNG
추석	*추석/NNG
추세	*추세/NNG
추쇄	*추쇄/NNG
추수	*추수/NNG
추식	*추식/NNP
추신	*추신/NNG
추심	*추심/NNG
추앙	*추앙/NNG
추억	*추억/NNG
추원	*추원/NNG
추월	*추월/NNG
추위	*추위/NNG
추이	*추이/NNG
추인	*추인/NNG
추장	*추장/NNG
추정	*추정/NNG
추존	*추존/NNG
추졸	*추졸/NNG
추종	*추종/NNG
추증	*추증/NNG
추지	*추지/NNG
추진	*추진/NNG
추징	*추징/NNG
추천	*추천/NNG
추첨	*추첨/NNG
추축	*추축/NNG
추출	*추출/NNG
추측	*추측/NNG
추탈	*추탈/NNG
추태	*추태/NNG
추파	*추파/NNG
추포	*추포/NNG
추하	*추하/VA
추행	*추행/NNG
추호	*추호/NNG
추회	*추회/NNG
추후	*추후/NNG
축객	*축객/NNG
축구	*축구/NNG
축귀	*축귀/NNG
축도	*축도/NNG
축동	*축동/NNG
축복	*축복/NNG
축사	*축사/NNG
축상	*축상/NNG
축성	*축성/NNG
축소	*축소/NNG
축수	*축수/NNG
축약	*축약/NNG
축역	*축역/NNG
축연	*축연/NNG
축원	*축원/NNG
축일	*축일/NNG
축재	*축재/NNG
축적	*축적/NNG
축전	*축전/NNG
축제	*축제/NNG
축조	*축조/NNG
축주	*축주/NNG
축지	*축지/NNG
축척	*축척/NNG
축첩	*축첩/NNG
축축	*축축/MAG
축출	*축출/NNG
축토	*축토/NNG
축하	*축하/NNG
축항	*축항/NNG
춘경	*춘경/NNG
춘기	*춘기/NNG
출가	*출가/NNG
출간	*출간/NNG
출감	*출감/NNG
출강	*출강/NNG
출격	*출격/NNG
출계	*출계/NNG
출고	*출고/NNG
출교	*출교/NNG
출구	*출구/NNG
출국	*출국/NNG
출근	*출근/NNG
출금	*출금/NNG
출급	*출급/NNG
출납	*출납/NNG
출당	*출당/NNG
출동	*출동/NNG
출두	*출두/NNG
출렁	*출렁/MAG
출력	*출력/NNG
출렵	*출렵/NNG
출루	*출루/NNG
출륙	*출륙/NNG
출림	*출림/NNG
출마	*출마/NNG
출몰	*출몰/NNG
출반	*출반/NNG
출발	*출발/NNG
출범	*출범/NNG
출병	*출병/NNG
출분	*출분/NNG
출사	*출사/NNG
출산	*출산/NNG
출상	*출상/NNG
출생	*출생/NNG
출석	*출석/NNG
출선	*출선/NNG
출성	*출성/NNG
출세	*출세/NNG
출소	*출소/NNG
출송	*출송/NNG
출수	*출수/NNG
출시	*출시/NNG
출신	*출신/NNG
출어	*출어/NNG
출역	*출역/NNG
출연	*출연/NNG
출영	*출영/NNG
출옥	*출옥/NNG
출원	*출원/NNG
출입	*출입/NNG
출자	*출자/NNG
출장	*출장/NNG
출재	*출재/NNG
출전	*출전/NNG
출점	*출점/NNG
출정	*출정/NNG
출제	*출제/NNG
출주	*출주/NNG
출진	*출진/NNG
출처	*출처/NNG
출척	*출척/NNG
출천	*출천/NNG
출초	*출초/NNG
출타	*출타/NNG
출토	*출토/NNG
출판	*출판/NNG
출포	*출포/NNG
출품	*출품/NNG
출하	*출하/NNG
출항	*출항/NNG
출행	*출행/NNG
출향	*출향/NNP
출현	*출현/NNG
출혈	*출혈/NNG
출회	*출회/NNG
충격	*충격/NNG
충고	*충고/NNG
충담	*충담/NNP
충당	*충당/NNG
충돌	*충돌/NNG
충동	*충동/NNG
충량	*충량/NNG
충렬	*충렬/NNG
충만	*충만/NNG
충복	*충복/NNG
충성	*충성/NNG
충수	*충수/NNG
충실	*충실/NNG
충심	*충심/NNG
충언	*충언/NNG
충원	*충원/NNG
충의	*충의/NNG
충이	*충이/NNG
충일	*충일/NNG
충적	*충적/NNG
충전	*충전/NNG
충정	*충정/NNG
충족	*충족/NNG
충직	*충직/NNG
충천	*충천/NNG
충혈	*충혈/NNG
췌사	*췌사/NNG
췌언	*췌언/NNG
취군	*취군/NNG
취급	*취급/NNG
취당	*취당/NNP
취득	*취득/NNG
취로	*취로/NNG
취리	*취리/NNG
취면	*취면/NNG
취반	*취반/NNG
취사	*취사/NNG
취소	*취소/NNG
취수	*취수/NNG
취식	*취식/NNG
취약	*취약/NNG
취업	*취업/NNG
취역	*취역/NNG
취음	*취음/NNG
취의	*취의/NNG
취인	*취인/NNG
취임	*취임/NNG
취입	*취입/NNG
취재	*취재/NNG
취조	*취조/NNG
취지	*취지/NNG
취직	*취직/NNG
취체	*취체/NNG
취침	*취침/NNG
취탈	*취탈/NNG
취택	*취택/NNG
취토	*취토/NNG
취학	*취학/NNG
취합	*취합/NNG
취항	*취항/NNG
취허	*취허/VV
측공	*측공/NNG
측광	*측광/NNG
측량	*측량/NNG
측목	*측목/NNG
측색	*측색/NNG
측와	*측와/NNG
측정	*측정/NNG
측천	*측천/NNG
층하	*층하/NNG
층화	*층화/NNG
치경	*치경/NNG
치관	*치관/NNG
치국	*치국/NNG
치근	*치근/NNG
치기	*치기/NNG
치담	*치담/NNG
치덕	*치덕/NNG
치도	*치도/NNG
치란	*치란/NNG
치레	*치레/NNG
치료	*치료/NNG
치마	*치마/NNG
치매	*치매/NNG
치명	*치명/NNG
치모	*치모/NNG
치목	*치목/NNG
치미	*치미/NNG
치민	*치민/NNG
치밀	*치밀/VV
치병	*치병/NNG
치부	*치부/NNG
치사	*치사/NNG
치산	*치산/NNG
치상	*치상/NNG
치석	*치석/NNG
치선	*치선/NNG
치성	*치성/NNG
치세	*치세/NNG
치소	*치소/NNG
치수	*치수/NNG
치안	*치안/NNG
치열	*치열/NNG
치원	*치원/NNP
치위	*치위/NNG
치유	*치유/NNG
치의	*치의/NNG
치인	*치인/NNG
치장	*치장/NNG
치적	*치적/NNG
치전	*치전/NNG
치정	*치정/NNG
치조	*치조/NNG
치졸	*치졸/NNG
치죄	*치죄/NNG
치중	*치중/NNG
치지	*치지/NNG
치패	*치패/NNG
치포	*치포/NNP
치하	*치하/NNG
치행	*치행/NNG
치환	*치환/NNG
칙어	*칙어/NNG
칙칙	*칙칙/MAG
칙허	*칙허/NNG
친견	*친견/NNG
친구	*친구/NNG
친면	*친면/NNG
친목	*친목/NNG
친밀	*친밀/NNG
친서	*친서/NNG
친선	*친선/NNG
친수	*친수/NNG
친숙	*친숙/NNG
친신	*친신/NNG
친심	*친심/NNG
친애	*친애/NNG
친영	*친영/NNG
친예	*친예/NNG
친왕	*친왕/NNG
친자	*친자/NNG
친작	*친작/NNG
친재	*친재/NNG
친전	*친전/NNG
친절	*친절/NNG
친접	*친접/NNG
친정	*친정/NNG
친제	*친제/NNG
친진	*친진/NNG
친친	*친친/MAG
친탁	*친탁/NNG
친행	*친행/NNG
친화	*친화/NNG
칠갑	*칠갑/NNG
침강	*침강/NNG
침공	*침공/NNG
침구	*침구/NNG
침노	*침노/NNG
침략	*침략/NNG
침몰	*침몰/NNG
침묵	*침묵/NNG
침범	*침범/NNG
침선	*침선/NNG
침수	*침수/NNG
침습	*침습/NNG
침식	*침식/NNG
침월	*침월/NNG
침윤	*침윤/NNG
침입	*침입/NNG
침잠	*침잠/NNG
침장	*침장/NNG
침적	*침적/NNG
침전	*침전/NNG
침정	*침정/NNG
침중	*침중/NNG
침지	*침지/NNG
침착	*침착/NNG
침체	*침체/NNG
침출	*침출/NNG
침치	*침치/NNG
침칠	*침칠/NNG
침탈	*침탈/NNG
침통	*침통/NNG
침투	*침투/NNG
침핍	*침핍/NNG
침하	*침하/NNG
침해	*침해/NNG
침훼	*침훼/NNG
칩거	*칩거/NNG
칭송	*칭송/NNG
칭원	*칭원/NNG
칭제	*칭제/NNG
칭찬	*칭찬/NNG
칭칭	*칭칭/MAG
칭탁	*칭탁/NNG
카트	*카트/NNG
카피	*카피/NNG
칵칵	*칵칵/MAG
캄캄	*캄캄/MAG
캉캉	*캉캉/NNG
캑캑	*캑캑/MAG
캠핑	*캠핑/NNG
커닝	*커닝/NNG
커버	*커버/NNG
커트	*커트/NNG
컥컥	*컥컥/MAG
컴백	*컴백/NNG
컹컹	*컹컹/MAG
코디	*코디/NNG
코딩	*코딩/NNG
코믹	*코믹/NNG
코치	*코치/NNG
코팅	*코팅/NNG
콕콕	*콕콕/MAG
콜록	*콜록/MAG
콜콜	*콜콜/MAG
콩콩	*콩콩/MAG
콱콱	*콱콱/MAG
콸콸	*콸콸/MAG
쾅쾅	*쾅쾅/MAG
쾌락	*쾌락/NNG
쾌미	*쾌미/NNG
쾌속	*쾌속/NNG
쾌승	*쾌승/NNG
쾌연	*쾌연/NNG
쾌유	*쾌유/NNG
쾌차	*쾌차/NNG
쾌척	*쾌척/NNG
쾌투	*쾌투/NNG
쿡쿡	*쿡쿡/MAG
쿨럭	*쿨럭/MAG
쿨렁	*쿨렁/MAG
쿨룩	*쿨룩/MAG
쿨쿨	*쿨쿨/MAG
쿵쾅	*쿵쾅/MAG
쿵쿵	*쿵쿵/MAG
쿵탕	*쿵탕/MAG
큰절	*큰절/NNG
클락	*클락/NNP
클릭	*클릭/NNG
클클	*클클/MAG
큼큼	*큼큼/MAG
킁킁	*킁킁/MAG
키스	*키스/NNG
키질	*키질/NNG
킥킥	*킥킥/MAG
킬킬	*킬킬/MAG
타개	*타개/NNG
타격	*타격/NNG
타결	*타결/NNG
타계	*타계/NNG
타구	*타구/NNG
타닥	*타닥/MAG
타당	*타당/NNG
타락	*타락/NNG
타래	*타래/NNG
타령	*타령/NNG
타매	*타매/NNG
타면	*타면/NNG
타박	*타박/NNG
타산	*타산/NNG
타살	*타살/NNG
타수	*타수/NNG
타의	*타의/NNG
타인	*타인/NNG
타입	*타입/NNG
타자	*타자/NNG
타작	*타작/NNG
타전	*타전/NNG
타점	*타점/NNG
타제	*타제/NNG
타종	*타종/NNG
타진	*타진/NNG
타천	*타천/NNG
타파	*타파/NNG
타행	*타행/NNG
타협	*타협/NNG
탁란	*탁란/NNG
탁마	*탁마/NNG
탁발	*탁발/NNG
탁방	*탁방/NNG
탁본	*탁본/NNG
탁상	*탁상/NNG
탁송	*탁송/NNG
탁수	*탁수/NNG
탁신	*탁신/NNP
탁의	*탁의/NNG
탁자	*탁자/NNG
탁족	*탁족/NNG
탁치	*탁치/NNG
탁탁	*탁탁/MAG
탄금	*탄금/NNG
탄로	*탄로/NNG
탄복	*탄복/NNG
탄사	*탄사/NNG
탄생	*탄생/NNG
탄성	*탄성/NNG
탄소	*탄소/NNG
탄식	*탄식/NNG
탄실	*탄실/NNG
탄압	*탄압/NNG
탄원	*탄원/NNG
탄주	*탄주/NNG
탄하	*탄하/VV
탄핵	*탄핵/NNG
탄화	*탄화/NNG
탈각	*탈각/NNG
탈고	*탈고/NNG
탈곡	*탈곡/NNG
탈골	*탈골/NNG
탈구	*탈구/NNG
탈권	*탈권/NNG
탈기	*탈기/NNG
탈농	*탈농/NNG
탈당	*탈당/NNG
탈락	*탈락/NNG
탈력	*탈력/NNG
탈루	*탈루/NNG
탈린	*탈린/NNP
탈모	*탈모/NNG
탈법	*탈법/NNG
탈상	*탈상/NNG
탈색	*탈색/NNG
탈선	*탈선/NNG
탈세	*탈세/NNG
탈속	*탈속/NNG
탈수	*탈수/NNG
탈신	*탈신/NNG
탈영	*탈영/NNG
탈옥	*탈옥/NNG
탈장	*탈장/NNG
탈절	*탈절/NNG
탈주	*탈주/NNG
탈지	*탈지/NNG
탈진	*탈진/NNG
탈출	*탈출/NNG
탈취	*탈취/NNG
탈탈	*탈탈/MAG
탈퇴	*탈퇴/NNG
탈피	*탈피/NNG
탈항	*탈항/NNG
탈환	*탈환/NNG
탈황	*탈황/NNG
탐광	*탐광/NNG
탐구	*탐구/NNG
탐닉	*탐닉/NNG
탐독	*탐독/NNG
탐락	*탐락/NNG
탐리	*탐리/NNG
탐매	*탐매/NNP
탐문	*탐문/NNG
탐미	*탐미/NNG
탐방	*탐방/NNG
탐사	*탐사/NNG
탐색	*탐색/NNG
탐승	*탐승/NNG
탐식	*탐식/NNG
탐악	*탐악/NNG
탐애	*탐애/NNG
탐장	*탐장/NNP
탐정	*탐정/NNG
탐조	*탐조/NNG
탐지	*탐지/NNG
탐학	*탐학/NNG
탐험	*탐험/NNG
탐화	*탐화/NNG
탑승	*탑승/NNG
탑재	*탑재/NNG
탕감	*탕감/NNG
탕관	*탕관/NNG
탕산	*탕산/NNP
탕정	*탕정/NNG
탕진	*탕진/NNG
탕탕	*탕탕/MAG
탕평	*탕평/NNG
태가	*태가/NNG
태고	*태고/NNG
태공	*태공/NNG
태교	*태교/NNG
태동	*태동/NNG
태만	*태만/NNG
태벌	*태벌/NNG
태봉	*태봉/NNP
태사	*태사/NNG
태생	*태생/NNG
태안	*태안/NNP
태양	*태양/NNG
태업	*태업/NNG
태연	*태연/NNG
태조	*태조/NNP
태중	*태중/NNG
태질	*태질/NNG
태클	*태클/NNG
태평	*태평/NNG
태형	*태형/NNG
태환	*태환/NNP
택일	*택일/NNG
택지	*택지/NNG
탱천	*탱천/NNG
탱탱	*탱탱/MAG
터득	*터득/NNG
터울	*터울/NNG
터치	*터치/NNG
턱짓	*턱짓/NNG
턱턱	*턱턱/MAG
털썩	*털썩/MAG
텀벙	*텀벙/MAG
텃세	*텃세/NNG
텅텅	*텅텅/MAG
토대	*토대/NNG
토렴	*토렴/NNG
토로	*토로/NNG
토론	*토론/NNG
토멸	*토멸/NNG
토문	*토문/NNG
토벌	*토벌/NNG
토비	*토비/NNP
토빈	*토빈/NNP
토사	*토사/NNG
토색	*토색/NNG
토설	*토설/NNG
토스	*토스/NNG
토심	*토심/NNG
토역	*토역/NNG
토용	*토용/NNG
토의	*토의/NNG
토이	*토이/NNG
토장	*토장/NNG
토제	*토제/NNG
토주	*토주/NNG
토착	*토착/NNG
토축	*토축/NNG
토탄	*토탄/NNG
토파	*토파/NNG
토혈	*토혈/NNG
톡톡	*톡톡/MAG
톨톨	*톨톨/MAG
통가	*통가/NNP
통간	*통간/NNG
통감	*통감/NNG
통격	*통격/NNG
통계	*통계/NNG
통고	*통고/NNG
통곡	*통곡/NNG
통공	*통공/NNG
통과	*통과/NNG
통관	*통관/NNG
통괄	*통괄/NNG
통교	*통교/NNG
통근	*통근/NNG
통금	*통금/NNG
통기	*통기/NNG
통념	*통념/NNG
통단	*통단/NNG
통달	*통달/NNG
통독	*통독/NNG
통령	*통령/NNG
통리	*통리/NNP
통맥	*통맥/NNG
통명	*통명/NNG
통모	*통모/NNG
통박	*통박/NNG
통방	*통방/NNG
통변	*통변/NNG
통보	*통보/NNG
통분	*통분/NNG
통비	*통비/NNG
통사	*통사/NNG
통산	*통산/NNG
통석	*통석/NNG
통설	*통설/NNG
통성	*통성/NNG
통소	*통소/NNG
통속	*통속/NNG
통솔	*통솔/NNG
통수	*통수/NNG
통시	*통시/NNG
통신	*통신/NNG
통어	*통어/NNG
통역	*통역/NNG
통용	*통용/NNG
통원	*통원/NNG
통음	*통음/NNG
통의	*통의/NNG
통일	*통일/NNG
통재	*통재/NNG
통전	*통전/NNG
통절	*통절/NNG
통정	*통정/NNG
통제	*통제/NNG
통지	*통지/NNG
통찰	*통찰/NNG
통창	*통창/NNG
통첩	*통첩/NNG
통촉	*통촉/NNG
통치	*통치/NNG
통칭	*통칭/NNG
통쾌	*통쾌/NNG
통탄	*통탄/NNG
통통	*통통/MAG
통판	*통판/NNG
통풍	*통풍/NNG
통학	*통학/NNG
통합	*통합/NNG
통행	*통행/NNG
통혼	*통혼/NNG
통화	*통화/NNG
통회	*통회/NNG
퇴각	*퇴각/NNG
퇴거	*퇴거/NNG
퇴고	*퇴고/NNG
퇴관	*퇴관/NNG
퇴교	*퇴교/NNG
퇴궐	*퇴궐/NNG
퇴근	*퇴근/NNG
퇴기	*퇴기/NNG
퇴락	*퇴락/NNG
퇴로	*퇴로/NNG
퇴박	*퇴박/NNG
퇴보	*퇴보/NNG
퇴비	*퇴비/NNG
퇴사	*퇴사/NNG
퇴상	*퇴상/NNG
퇴색	*퇴색/NNG
퇴소	*퇴소/NNG
퇴수	*퇴수/NNG
퇴식	*퇴식/NNG
퇴실	*퇴실/NNG
퇴역	*퇴역/NNG
퇴염	*퇴염/NNG
퇴영	*퇴영/NNG
퇴원	*퇴원/NNG
퇴위	*퇴위/NNG
퇴임	*퇴임/NNG
퇴장	*퇴장/NNG
퇴적	*퇴적/NNG
퇴전	*퇴전/NNG
퇴정	*퇴정/NNG
퇴조	*퇴조/NNG
퇴주	*퇴주/NNG
퇴직	*퇴직/NNG
퇴진	*퇴진/NNG
퇴창	*퇴창/NNG
퇴청	*퇴청/NNG
퇴촌	*퇴촌/NNG
퇴축	*퇴축/NNG
퇴출	*퇴출/NNG
퇴치	*퇴치/NNG
퇴폐	*퇴폐/NNG
퇴학	*퇴학/NNG
퇴행	*퇴행/NNG
퇴화	*퇴화/NNG
투각	*투각/NNG
투견	*투견/NNG
투계	*투계/NNG
투고	*투고/NNG
투과	*투과/NNG
투광	*투광/NNG
투구	*투구/NNG
투도	*투도/NNG
투망	*투망/NNG
투매	*투매/NNG
투명	*투명/NNG
투병	*투병/NNG
투사	*투사/NNG
투살	*투살/NNG
투서	*투서/NNG
투석	*투석/NNG
투수	*투수/NNG
투숙	*투숙/NNG
투시	*투시/NNG
투식	*투식/NNG
투신	*투신/NNG
투약	*투약/NNG
투여	*투여/NNG
투영	*투영/NNG
투옥	*투옥/NNG
투우	*투우/NNG
투입	*투입/NNG
투자	*투자/NNG
투쟁	*투쟁/NNG
투전	*투전/NNG
투정	*투정/NNG
투지	*투지/NNG
투창	*투창/NNG
투척	*투척/NNG
투탁	*투탁/NNG
투표	*투표/NNG
투하	*투하/NNG
투합	*투합/NNG
투항	*투항/NNG
투호	*투호/NNG
투화	*투화/NNG
툭툭	*툭툭/MAG
툴툴	*툴툴/MAG
툼벙	*툼벙/MAG
퉁명	*퉁명/NNG
퉁탕	*퉁탕/MAG
퉁퉁	*퉁퉁/MAG
퉤퉤	*퉤퉤/MAG
튀김	*튀김/NNG
트림	*트림/NNG
트집	*트집/NNG
특감	*특감/NNG
특강	*특강/NNG
특고	*특고/NNG
특근	*특근/NNG
특급	*특급/NNG
특기	*특기/NNG
특대	*특대/NNG
특매	*특매/NNG
특명	*특명/NNG
특발	*특발/NNG
특별	*특별/NNG
특보	*특보/NNG
특사	*특사/NNG
특선	*특선/NNG
특설	*특설/NNG
특수	*특수/NNG
특약	*특약/NNG
특용	*특용/NNG
특유	*특유/NNG
특융	*특융/NNG
특이	*특이/NNG
특임	*특임/NNG
특정	*특정/NNG
특제	*특제/NNG
특진	*특진/NNG
특징	*특징/NNG
특차	*특차/NNG
특채	*특채/NNG
특청	*특청/NNG
특파	*특파/NNG
특필	*특필/NNG
특허	*특허/NNG
특화	*특화/NNG
틈입	*틈입/NNG
팅팅	*팅팅/MAG
파격	*파격/NNG
파견	*파견/NNG
파계	*파계/NNG
파공	*파공/NNG
파괴	*파괴/NNG
파국	*파국/NNG
파급	*파급/NNG
파기	*파기/NNG
파내	*파내/VV
파마	*파마/NNG
파면	*파면/NNG
파멸	*파멸/NNG
파문	*파문/NNG
파방	*파방/NNG
파벌	*파벌/NNG
파별	*파별/NNG
파병	*파병/NNG
파사	*파사/NNG
파삭	*파삭/MAG
파산	*파산/NNG
파상	*파상/NNG
파생	*파생/NNG
파선	*파선/NNG
파손	*파손/NNG
파송	*파송/NNG
파쇄	*파쇄/NNG
파수	*파수/NNG
파시	*파시/NNG
파악	*파악/NNG
파업	*파업/NNG
파열	*파열/NNG
파옥	*파옥/NNG
파월	*파월/NNG
파의	*파의/NNG
파임	*파임/NNG
파자	*파자/NNG
파장	*파장/NNG
파쟁	*파쟁/NNG
파적	*파적/NNG
파전	*파전/NNG
파제	*파제/NNG
파조	*파조/NNG
파종	*파종/NNG
파주	*파주/NNP
파지	*파지/NNG
파직	*파직/NNG
파천	*파천/NNG
파탄	*파탄/NNG
파탈	*파탈/NNG
파토	*파토/NNG
파투	*파투/NNG
파파	*파파/NNP
파필	*파필/NNG
파하	*파하/VV
파행	*파행/NNG
파혼	*파혼/NNG
판각	*판각/NNG
판결	*판결/NNG
판금	*판금/NNG
판단	*판단/NNG
판도	*판도/NNG
판독	*판독/NNG
판리	*판리/NNG
판매	*판매/NNG
판명	*판명/NNG
판별	*판별/NNG
판비	*판비/NNG
판상	*판상/NNG
판서	*판서/NNG
판시	*판시/NNG
판정	*판정/NNG
판지	*판지/NNG
판화	*판화/NNG
팔달	*팔달/NNG
팔딱	*팔딱/MAG
팔랑	*팔랑/MAG
팔매	*팔매/NNG
팔짓	*팔짓/NNG
팔짝	*팔짝/MAG
팔팔	*팔팔/MAG
팡팡	*팡팡/MAG
패덕	*패덕/NNG
패도	*패도/NNG
패류	*패류/NNG
패륜	*패륜/NNG
패리	*패리/NNP
패망	*패망/NNG
패배	*패배/NNG
패사	*패사/NNG
패산	*패산/NNG
패설	*패설/NNG
패소	*패소/NNG
패스	*패스/NNG
패악	*패악/NNG
패업	*패업/NNG
패용	*패용/NNG
패잔	*패잔/NNG
패전	*패전/NNG
패주	*패주/NNG
패킹	*패킹/NNG
패퇴	*패퇴/NNG
팽대	*팽대/NNG
팽만	*팽만/NNG
팽배	*팽배/NNG
팽윤	*팽윤/NNG
팽조	*팽조/NNP
팽창	*팽창/NNG
팽팽	*팽팽/MAG
팽화	*팽화/NNG
퍼뜩	*퍼뜩/MAG
퍼석	*퍼석/MAG
퍼트	*퍼트/NNG
퍼팅	*퍼팅/NNG
펀뜻	*펀뜻/MAG
펀칭	*펀칭/NNG
펄떡	*펄떡/MAG
펄럭	*펄럭/MAG
펄썩	*펄썩/MAG
펄쩍	*펄쩍/MAG
펄펄	*펄펄/MAG
펑펑	*펑펑/MAG
페소	*페소/NNB
편경	*편경/NNG
편곡	*편곡/NNG
편년	*편년/NNG
편달	*편달/NNG
편력	*편력/NNG
편리	*편리/NNG
편복	*편복/NNG
편성	*편성/NNG
편승	*편승/NNG
편식	*편식/NNG
편쌈	*편쌈/NNG
편안	*편안/NNG
편애	*편애/NNG
편의	*편의/NNG
편익	*편익/NNG
편입	*편입/NNG
편작	*편작/NNG
편재	*편재/NNG
편저	*편저/NNG
편적	*편적/NNG
편제	*편제/NNG
편조	*편조/NNG
편중	*편중/NNG
편지	*편지/NNG
편집	*편집/NNG
편차	*편차/NNG
편찬	*편찬/NNG
편철	*편철/NNG
편청	*편청/NNG
편취	*편취/NNG
편파	*편파/NNG
편향	*편향/NNG
편협	*편협/NNG
폄척	*폄척/NNG
폄출	*폄출/NNG
폄하	*폄하/NNG
폄훼	*폄훼/NNG
평가	*평가/NNG
평강	*평강/NNG
평결	*평결/NNG
평교	*평교/NNG
평균	*평균/NNG
평등	*평등/NNG
평량	*평량/NNG
평론	*평론/NNG
평문	*평문/NNG
평반	*평반/NNG
평방	*평방/NNG
평복	*평복/NNG
평사	*평사/NNG
평석	*평석/NNP
평설	*평설/NNG
평심	*평심/NNG
평안	*평안/NNG
평온	*평온/NNG
평원	*평원/NNG
평의	*평의/NNG
평장	*평장/NNG
평정	*평정/NNG
평좌	*평좌/NNG
평준	*평준/NNG
평탄	*평탄/NNG
평토	*평토/NNG
평판	*평판/NNG
평행	*평행/NNG
평형	*평형/NNG
평화	*평화/NNG
폐간	*폐간/NNG
폐강	*폐강/NNG
폐경	*폐경/NNG
폐과	*폐과/NNG
폐관	*폐관/NNG
폐광	*폐광/NNG
폐교	*폐교/NNG
폐궁	*폐궁/NNG
폐기	*폐기/NNG
폐농	*폐농/NNG
폐동	*폐동/NNG
폐륜	*폐륜/NNG
폐막	*폐막/NNG
폐모	*폐모/NNG
폐문	*폐문/NNG
폐부	*폐부/NNG
폐비	*폐비/NNG
폐사	*폐사/NNG
폐색	*폐색/NNG
폐쇄	*폐쇄/NNG
폐업	*폐업/NNG
폐용	*폐용/NNG
폐원	*폐원/NNG
폐위	*폐위/NNG
폐읍	*폐읍/NNG
폐장	*폐장/NNG
폐전	*폐전/NNG
폐절	*폐절/NNG
폐점	*폐점/NNG
폐정	*폐정/NNG
폐지	*폐지/NNG
폐창	*폐창/NNG
폐출	*폐출/NNG
폐치	*폐치/NNG
폐합	*폐합/NNG
폐회	*폐회/NNG
포격	*포격/NNG
포경	*포경/NNG
포고	*포고/NNG
포곡	*포곡/NNG
포과	*포과/NNG
포괄	*포괄/NNG
포교	*포교/NNG
포구	*포구/NNG
포국	*포국/NNG
포기	*포기/NNG
포달	*포달/NNG
포도	*포도/NNG
포락	*포락/NNG
포란	*포란/NNG
포로	*포로/NNG
포만	*포만/NNG
포문	*포문/NNG
포박	*포박/NNG
포백	*포백/NNG
포병	*포병/NNG
포복	*포복/NNG
포사	*포사/NNG
포살	*포살/NNG
포상	*포상/NNG
포석	*포석/NNG
포설	*포설/NNG
포섭	*포섭/NNG
포수	*포수/NNG
포승	*포승/NNG
포식	*포식/NNG
포악	*포악/NNG
포옥	*포옥/MAG
포옹	*포옹/NNG
포용	*포용/NNG
포원	*포원/NNG
포위	*포위/NNG
포유	*포유/NNG
포육	*포육/NNG
포의	*포의/NNG
포자	*포자/NNG
포장	*포장/NNG
포전	*포전/NNG
포조	*포조/NNP
포지	*포지/NNG
포진	*포진/NNG
포집	*포집/NNG
포착	*포착/NNG
포천	*포천/NNP
포철	*포철/NNP
포치	*포치/NNG
포탈	*포탈/NNG
포태	*포태/NNG
포토	*포토/NNG
포폄	*포폄/NNG
포한	*포한/NNG
포함	*포함/NNG
포화	*포화/NNG
포획	*포획/NNG
포효	*포효/NNG
포흠	*포흠/NNG
폭격	*폭격/NNG
폭등	*폭등/NNG
폭락	*폭락/NNG
폭로	*폭로/NNG
폭발	*폭발/NNG
폭배	*폭배/NNG
폭사	*폭사/NNG
폭삭	*폭삭/MAG
폭서	*폭서/NNG
폭설	*폭설/NNG
폭소	*폭소/NNG
폭식	*폭식/NNG
폭압	*폭압/NNG
폭양	*폭양/NNG
폭언	*폭언/NNG
폭음	*폭음/NNG
폭주	*폭주/NNG
폭침	*폭침/NNG
폭파	*폭파/NNG
폭행	*폭행/NNG
폴딱	*폴딱/MAG
폴락	*폴락/NNP
폴싹	*폴싹/MAG
폴짝	*폴짝/MAG
폴폴	*폴폴/MAG
퐁당	*퐁당/MAG
퐁퐁	*퐁퐁/MAG
표결	*표결/NNG
표구	*표구/NNG
표기	*표기/NNG
표독	*표독/NNG
표랑	*표랑/NNG
표류	*표류/NNG
표명	*표명/NNG
표박	*표박/NNG
표방	*표방/NNG
표백	*표백/NNG
표변	*표변/NNG
표상	*표상/NNG
표시	*표시/NNG
표식	*표식/NNG
표음	*표음/NNG
표의	*표의/NNG
표장	*표장/NNG
표재	*표재/NNG
표적	*표적/NNG
표전	*표전/NNG
표절	*표절/NNG
표정	*표정/NNG
표지	*표지/NNG
표착	*표착/NNG
표창	*표창/NNG
표출	*표출/NNG
표한	*표한/NNG
표현	*표현/NNG
푸념	*푸념/NNG
푸들	*푸들/NNG
푸륵	*푸륵/MAG
푸새	*푸새/NNG
푸주	*푸주/NNG
푸푸	*푸푸/MAG
푹석	*푹석/MAG
푹신	*푹신/MAG
푹푹	*푹푹/MAG
풀쌈	*풀쌈/NNG
풀썩	*풀썩/MAG
풀쩍	*풀쩍/MAG
풀칠	*풀칠/NNG
풀풀	*풀풀/MAG
품귀	*품귀/NNG
품달	*품달/NNG
품명	*품명/NNG
품신	*품신/NNG
품절	*품절/NNG
품정	*품정/NNG
품평	*품평/NNG
풍경	*풍경/NNG
풍덩	*풍덩/MAG
풍동	*풍동/NNG
풍류	*풍류/NNG
풍마	*풍마/NNG
풍미	*풍미/NNG
풍비	*풍비/NNG
풍산	*풍산/NNP
풍생	*풍생/NNP
풍선	*풍선/NNG
풍신	*풍신/NNG
풍양	*풍양/NNP
풍요	*풍요/NNG
풍월	*풍월/NNG
풍유	*풍유/NNG
풍자	*풍자/NNG
풍풍	*풍풍/NNG
풍화	*풍화/NNG
피갑	*피갑/NNG
피격	*피격/NNG
피곤	*피곤/NNG
피난	*피난/NNG
피란	*피란/NNG
피랍	*피랍/NNG
피력	*피력/NNG
피로	*피로/NNG
피리	*피리/NNG
피박	*피박/NNG
피복	*피복/NNG
피비	*피비/NNP
피살	*피살/NNG
피서	*피서/NNG
피선	*피선/NNG
피소	*피소/NNG
피습	*피습/NNG
피시	*피시/NNG
피식	*피식/MAG
피신	*피신/NNG
피의	*피의/NNG
피임	*피임/NNG
피전	*피전/NNG
피정	*피정/NNG
피진	*피진/NNG
피체	*피체/NNG
피침	*피침/NNG
피칭	*피칭/NNG
피탈	*피탈/NNG
피폐	*피폐/NNG
피폭	*피폭/NNG
피한	*피한/NNG
피해	*피해/NNG
피화	*피화/NNG
픽업	*픽업/NNG
픽픽	*픽픽/MAG
핀잔	*핀잔/NNG
필경	*필경/MAG
필기	*필기/NNG
필담	*필담/NNG
필답	*필답/NNG
필독	*필독/NNG
필멸	*필멸/NNG
필배	*필배/NNP
필벌	*필벌/NNG
필봉	*필봉/NNG
필사	*필사/NNG
필산	*필산/NNG
필성	*필성/NNP
필수	*필수/NNG
필승	*필승/NNG
필연	*필연/NNG
필요	*필요/NNG
필적	*필적/NNG
필전	*필전/NNG
필주	*필주/NNP
핍박	*핍박/NNG
핑계	*핑계/NNG
핑핑	*핑핑/MAG
하강	*하강/NNG
하경	*하경/NNG
하관	*하관/NNG
하교	*하교/NNG
하늘	*하늘/NNG
하단	*하단/NNG
하달	*하달/NNG
하답	*하답/NNG
하동	*하동/NNP
하락	*하락/NNG
하략	*하략/NNG
하례	*하례/NNG
하롱	*하롱/NNP
하루	*하루/NNG
하륙	*하륙/NNG
하림	*하림/NNP
하명	*하명/NNG
하문	*하문/NNG
하부	*하부/NNG
하비	*하비/NNP
하사	*하사/NNG
하산	*하산/NNG
하상	*하상/NNG
하생	*하생/NNG
하선	*하선/NNG
하세	*하세/NNG
하소	*하소/NNG
하수	*하수/NNG
하숙	*하숙/NNG
하순	*하순/NNG
하야	*하야/NNG
하역	*하역/NNG
하영	*하영/NNP
하오	*하오/NNG
하옥	*하옥/NNG
하원	*하원/NNG
하위	*하위/NNG
하의	*하의/NNG
하저	*하저/NNG
하전	*하전/NNG
하조	*하조/NNP
하직	*하직/NNG
하차	*하차/NNG
하처	*하처/NNG
하천	*하천/NNG
하청	*하청/NNG
하체	*하체/NNG
하치	*하치/NNG
하품	*하품/NNG
하필	*하필/MAG
하하	*하하/IC
하학	*하학/NNG
하행	*하행/NNG
하향	*하향/NNG
하혈	*하혈/NNG
하화	*하화/NNG
하회	*하회/NNG
학기	*학기/NNG
학대	*학대/NNG
학문	*학문/NNG
학사	*학사/NNG
학살	*학살/NNG
학수	*학수/NNP
학습	*학습/NNG
학식	*학식/NNG
학우	*학우/NNG
한갓	*한갓/MAG
한광	*한광/NNP
한국	*한국/NNP
한담	*한담/NNG
한독	*한독/NNP
한둔	*한둔/NNG
한랭	*한랭/NNG
한량	*한량/NNG
한려	*한려/NNG
한몫	*한몫/NNG
한미	*한미/NNG
한배	*한배/NNG
한별	*한별/NNP
한보	*한보/NNP
한빈	*한빈/NNP
한양	*한양/NNP
한어	*한어/NNP
한역	*한역/NNG
한음	*한음/NNP
한의	*한의/NNG
한잔	*한잔/NNG
한전	*한전/NNP
한절	*한절/NNG
한정	*한정/NNG
한직	*한직/NNG
한천	*한천/NNG
한축	*한축/NNG
한탄	*한탄/NNG
한턱	*한턱/NNG
할끔	*할끔/MAG
할당	*할당/NNG
할복	*할복/NNG
할부	*할부/NNG
할석	*할석/NNG
할애	*할애/NNG
할양	*할양/NNG
할인	*할인/NNG
할증	*할증/NNG
함구	*함구/NNG
함께	*함께/MAG
함락	*함락/NNG
함몰	*함몰/NNG
함묵	*함묵/NNG
함분	*함분/NNG
함성	*함성/NNG
함수	*함수/NNG
함양	*함양/NNG
함유	*함유/NNG
함의	*함의/NNG
함축	*함축/NNG
함해	*함해/NNG
합가	*합가/NNG
합각	*합각/NNG
합격	*합격/NNG
합계	*합계/NNG
합궁	*합궁/NNG
합금	*합금/NNG
합당	*합당/NNG
합동	*합동/NNG
합력	*합력/NNG
합례	*합례/NNG
합로	*합로/NNG
합류	*합류/NNG
합리	*합리/NNG
합문	*합문/NNG
합반	*합반/NNG
합방	*합방/NNG
합법	*합법/NNG
합벽	*합벽/NNG
합병	*합병/NNG
합본	*합본/NNG
합사	*합사/NNG
합산	*합산/NNG
합석	*합석/NNG
합선	*합선/NNG
합설	*합설/NNG
합성	*합성/NNG
합세	*합세/NNG
합송	*합송/NNG
합수	*합수/NNG
합숙	*합숙/NNG
합승	*합승/NNG
합심	*합심/NNG
합영	*합영/NNG
합의	*합의/NNG
합인	*합인/NNG
합일	*합일/NNG
합자	*합자/NNG
합작	*합작/NNG
합장	*합장/NNG
합전	*합전/NNG
합제	*합제/NNG
합종	*합종/NNG
합주	*합주/NNG
합창	*합창/NNG
합체	*합체/NNG
합판	*합판/NNG
합편	*합편/NNG
합평	*합평/NNG
합화	*합화/NNG
핫핫	*핫핫/IC
항거	*항거/NNG
항고	*항고/NNG
항공	*항공/NNG
항구	*항구/NNG
항례	*항례/NNG
항마	*항마/NNG
항명	*항명/NNG
항변	*항변/NNG
항복	*항복/NNG
항소	*항소/NNG
항속	*항속/NNG
항의	*항의/NNG
항일	*항일/NNG
항쟁	*항쟁/NNG
항전	*항전/NNG
항조	*항조/NNG
항주	*항주/NNP
항진	*항진/NNG
항해	*항해/NNG
항행	*항행/NNG
해갈	*해갈/NNG
해결	*해결/NNG
해고	*해고/NNG
해공	*해공/NNP
해관	*해관/NNG
해군	*해군/NNG
해금	*해금/NNG
해단	*해단/NNP
해답	*해답/NNG
해당	*해당/NNG
해대	*해대/VV
해독	*해독/NNG
해동	*해동/NNG
해득	*해득/NNG
해람	*해람/NNG
해량	*해량/NNG
해로	*해로/NNG
해면	*해면/NNG
해명	*해명/NNG
해몽	*해몽/NNG
해방	*해방/NNG
해복	*해복/NNG
해부	*해부/NNG
해비	*해비/NNG
해빙	*해빙/NNG
해산	*해산/NNG
해상	*해상/NNG
해석	*해석/NNG
해설	*해설/NNG
해소	*해소/NNG
해송	*해송/NNG
해시	*해시/NNG
해신	*해신/NNG
해악	*해악/NNG
해안	*해안/NNG
해약	*해약/NNG
해열	*해열/NNG
해왕	*해왕/NNP
해우	*해우/NNG
해원	*해원/NNG
해유	*해유/NNG
해이	*해이/NNG
해일	*해일/NNG
해임	*해임/NNG
해자	*해자/NNG
해장	*해장/NNG
해적	*해적/NNG
해정	*해정/NNP
해제	*해제/NNG
해조	*해조/NNG
해직	*해직/NNG
해차	*해차/NNG
해찰	*해찰/NNG
해참	*해참/NNG
해척	*해척/NNG
해체	*해체/NNG
해촉	*해촉/NNG
해탈	*해탈/NNG
해태	*해태/NNG
해토	*해토/NNG
해해	*해해/MAG
해화	*해화/NNG
해후	*해후/NNG
핵변	*핵변/NNG
행각	*행각/NNG
행간	*행간/NNG
행걸	*행걸/NNP
행공	*행공/NNG
행구	*행구/NNG
행군	*행군/NNG
행기	*행기/NNG
행동	*행동/NNG
행락	*행락/NNG
행려	*행려/NNG
행력	*행력/NNG
행렬	*행렬/NNG
행례	*행례/NNG
행로	*행로/NNG
행리	*행리/NNG
행마	*행마/NNG
행매	*행매/NNG
행문	*행문/NNG
행방	*행방/NNG
행보	*행보/NNG
행복	*행복/NNG
행불	*행불/NNG
행비	*행비/NNG
행사	*행사/NNG
행상	*행상/NNG
행선	*행선/NNG
행세	*행세/NNG
행시	*행시/NNG
행신	*행신/NNG
행악	*행악/NNG
행어	*행어/NNG
행역	*행역/NNG
행용	*행용/NNG
행우	*행우/NNG
행의	*행의/NNG
행작	*행작/NNG
행전	*행전/NNG
행주	*행주/NNG
행진	*행진/NNG
행차	*행차/NNG
행패	*행패/NNG
행형	*행형/NNG
향도	*향도/NNG
향락	*향락/NNG
향발	*향발/NNG
향배	*향배/NNG
향사	*향사/NNG
향상	*향상/NNG
향수	*향수/NNG
향양	*향양/NNG
향유	*향유/NNG
향응	*향응/NNG
향의	*향의/NNG
향인	*향인/NNG
향일	*향일/NNG
향진	*향진/NNP
향하	*향하/VV
향화	*향화/NNG
허가	*허가/NNG
허겁	*허겁/NNG
허구	*허구/NNG
허락	*허락/NNG
허례	*허례/NNG
허망	*허망/NNG
허무	*허무/NNG
허발	*허발/NNG
허배	*허배/NNG
허보	*허보/NNG
허비	*허비/NNG
허사	*허사/NNG
허송	*허송/NNG
허수	*허수/NNG
허시	*허시/VV
허식	*허식/NNG
허신	*허신/NNP
허실	*허실/NNG
허심	*허심/NNG
허약	*허약/NNG
허어	*허어/IC
허여	*허여/NNG
허영	*허영/NNG
허용	*허용/NNG
허유	*허유/NNP
허장	*허장/NNG
허정	*허정/NNP
허종	*허종/NNP
허탈	*허탈/NNG
허탕	*허탕/NNG
허턱	*허턱/MAG
허행	*허행/NNG
허혼	*허혼/NNG
헉헉	*헉헉/MAG
헌금	*헌금/NNG
헌납	*헌납/NNG
헌다	*헌다/NNG
헌병	*헌병/NNG
헌상	*헌상/NNG
헌수	*헌수/NNG
헌신	*헌신/NNG
헌의	*헌의/NNG
헌자	*헌자/NNG
헌작	*헌작/NNG
헌정	*헌정/NNG
헌주	*헌주/NNG
헌책	*헌책/NNG
헌혈	*헌혈/NNG
헌화	*헌화/NNG
헐떡	*헐떡/MAG
험구	*험구/NNG
험담	*험담/NNG
험산	*험산/NNG
험상	*험상/NNG
험색	*험색/NNG
험요	*험요/NNG
험지	*험지/NNG
헛짓	*헛짓/NNG
헝겁	*헝겁/NNG
헤살	*헤살/NNG
헤엄	*헤엄/NNG
헤헤	*헤헤/MAG
혁대	*혁대/NNG
혁명	*혁명/NNG
혁신	*혁신/NNG
혁정	*혁정/NNG
혁제	*혁제/NNG
혁진	*혁진/NNP
혁파	*혁파/NNG
현가	*현가/NNG
현격	*현격/NNG
현군	*현군/NNG
현금	*현금/NNG
현단	*현단/NNG
현달	*현달/NNG
현동	*현동/NNP
현란	*현란/NNG
현령	*현령/NNG
현록	*현록/NNG
현명	*현명/NNG
현몽	*현몽/NNG
현묘	*현묘/NNG
현미	*현미/NNG
현상	*현상/NNG
현성	*현성/NNG
현숙	*현숙/NNP
현시	*현시/NNG
현신	*현신/NNG
현양	*현양/NNG
현원	*현원/NNG
현장	*현장/NNG
현전	*현전/NNG
현정	*현정/NNG
현준	*현준/NNP
현지	*현지/NNG
현찰	*현찰/NNG
현창	*현창/NNG
현철	*현철/NNP
현토	*현토/NNG
현학	*현학/NNG
현행	*현행/NNG
현현	*현현/NNG
현호	*현호/NNP
현혹	*현혹/NNG
현황	*현황/NNG
현훈	*현훈/NNG
혈맹	*혈맹/NNG
혈서	*혈서/NNG
혈장	*혈장/NNG
혈전	*혈전/NNG
혈투	*혈투/NNG
혐기	*혐기/NNG
혐오	*혐오/NNG
혐원	*혐원/NNG
혐의	*혐의/NNG
혐한	*혐한/NNG
협간	*협간/NNG
협격	*협격/NNG
협공	*협공/NNG
협동	*협동/NNG
협량	*협량/NNG
협력	*협력/NNG
협박	*협박/NNG
협부	*협부/NNG
협상	*협상/NNG
협성	*협성/NNG
협시	*협시/NNG
협심	*협심/NNG
협애	*협애/NNG
협약	*협약/NNG
협업	*협업/NNG
협연	*협연/NNG
협의	*협의/NNG
협잡	*협잡/NNG
협정	*협정/NNG
협제	*협제/NNP
협조	*협조/NNG
협주	*협주/NNG
협착	*협착/NNG
협찬	*협찬/NNG
협화	*협화/NNG
형국	*형국/NNG
형문	*형문/NNG
형배	*형배/NNG
형벌	*형벌/NNG
형별	*형별/NNG
형사	*형사/NNG
형상	*형상/NNG
형성	*형성/NNG
형승	*형승/NNG
형언	*형언/NNG
형용	*형용/NNG
형주	*형주/NNP
형통	*형통/NNG
혜리	*혜리/NNP
혜림	*혜림/NNP
혜민	*혜민/NNP
혜시	*혜시/NNP
혜왕	*혜왕/NNP
혜철	*혜철/NNP
혜화	*혜화/NNP
호가	*호가/NNG
호감	*호감/NNG
호강	*호강/NNG
호객	*호객/NNG
호건	*호건/NNP
호구	*호구/NNG
호국	*호국/NNG
호군	*호군/NNG
호궤	*호궤/NNG
호기	*호기/NNG
호도	*호도/NNG
호란	*호란/NNG
호령	*호령/NNG
호명	*호명/NNG
호모	*호모/NNG
호박	*호박/NNG
호법	*호법/NNG
호보	*호보/NNP
호부	*호부/NNG
호사	*호사/NNG
호상	*호상/NNG
호색	*호색/NNG
호생	*호생/NNG
호석	*호석/NNG
호선	*호선/NNG
호세	*호세/NNP
호소	*호소/NNG
호송	*호송/NNG
호수	*호수/NNG
호승	*호승/NNG
호시	*호시/NNG
호식	*호식/NNG
호신	*호신/NNG
호앙	*호앙/NNP
호언	*호언/NNG
호연	*호연/NNG
호용	*호용/NNG
호우	*호우/NNG
호원	*호원/NNP
호위	*호위/NNG
호유	*호유/NNG
호음	*호음/NNG
호응	*호응/NNG
호장	*호장/NNG
호적	*호적/NNG
호전	*호전/NNG
호조	*호조/NNG
호종	*호종/NNG
호주	*호주/NNG
호준	*호준/NNP
호중	*호중/NNP
호창	*호창/NNP
호출	*호출/NNG
호칭	*호칭/NNG
호통	*호통/NNG
호투	*호투/NNG
호패	*호패/NNG
호평	*호평/NNG
호헌	*호헌/NNG
호형	*호형/NNG
호호	*호호/MAG
호화	*호화/NNG
호환	*호환/NNG
호흡	*호흡/NNG
혹사	*혹사/NNG
혹세	*혹세/NNG
혹평	*혹평/NNG
혹형	*혹형/NNG
혹혹	*혹혹/MAG
혼겁	*혼겁/NNG
혼곤	*혼곤/NNG
혼금	*혼금/NNG
혼돈	*혼돈/NNG
혼동	*혼동/NNG
혼란	*혼란/NNG
혼류	*혼류/NNG
혼망	*혼망/NNG
혼몽	*혼몽/NNG
혼미	*혼미/NNG
혼방	*혼방/NNG
혼사	*혼사/NNG
혼색	*혼색/NNG
혼생	*혼생/NNG
혼선	*혼선/NNG
혼성	*혼성/NNG
혼숙	*혼숙/NNG
혼식	*혼식/NNG
혼신	*혼신/NNG
혼약	*혼약/NNG
혼용	*혼용/NNG
혼융	*혼융/NNG
혼음	*혼음/NNG
혼인	*혼인/NNG
혼일	*혼일/NNG
혼입	*혼입/NNG
혼작	*혼작/NNG
혼잡	*혼잡/NNG
혼재	*혼재/NNG
혼적	*혼적/NNG
혼전	*혼전/NNG
혼절	*혼절/NNG
혼탁	*혼탁/NNG
혼탕	*혼탕/NNG
혼합	*혼합/NNG
혼행	*혼행/NNG
혼혈	*혼혈/NNG
혼효	*혼효/NNG
홀대	*홀대/NNG
홀딱	*홀딱/MAG
홀랑	*홀랑/MAG
홀시	*홀시/NNG
홀연	*홀연/MAG
홀저	*홀저/NNG
홀짝	*홀짝/MAG
홀홀	*홀홀/MAG
홈인	*홈인/NNG
홈질	*홈질/NNG
홍교	*홍교/NNG
홍대	*홍대/NNP
홍동	*홍동/NNP
홍법	*홍법/NNG
홍보	*홍보/NNG
홍소	*홍소/NNG
홍염	*홍염/NNG
홍의	*홍의/NNG
홍익	*홍익/NNG
홍제	*홍제/NNP
홍조	*홍조/NNG
홍포	*홍포/NNG
홍학	*홍학/NNG
화경	*화경/NNG
화공	*화공/NNG
화급	*화급/NNG
화끈	*화끈/MAG
화농	*화농/NNG
화담	*화담/NNG
화답	*화답/NNG
화덕	*화덕/NNG
화도	*화도/NNG
화동	*화동/NNG
화락	*화락/NNG
화매	*화매/NNG
화명	*화명/NNG
화목	*화목/NNG
화미	*화미/NNG
화복	*화복/NNG
화살	*화살/NNG
화생	*화생/NNG
화섬	*화섬/NNG
화성	*화성/NNP
화소	*화소/NNG
화속	*화속/NNG
화수	*화수/NNG
화순	*화순/NNP
화식	*화식/NNG
화신	*화신/NNG
화심	*화심/NNG
화약	*화약/NNG
화언	*화언/NNG
화용	*화용/NNG
화육	*화육/NNG
화의	*화의/NNG
화인	*화인/NNG
화장	*화장/NNG
화전	*화전/NNG
화점	*화점/NNG
화정	*화정/NNP
화조	*화조/NNG
화친	*화친/NNG
화타	*화타/NNP
화통	*화통/NNG
화투	*화투/NNG
화평	*화평/NNG
화합	*화합/NNG
화해	*화해/NNG
화행	*화행/NNG
화협	*화협/NNG
화호	*화호/NNG
화희	*화희/NNP
확단	*확단/NNG
확답	*확답/NNG
확대	*확대/NNG
확립	*확립/NNG
확보	*확보/NNG
확산	*확산/NNG
확신	*확신/NNG
확약	*확약/NNG
확언	*확언/NNG
확인	*확인/NNG
확장	*확장/NNG
확정	*확정/NNG
확증	*확증/NNG
확진	*확진/NNG
확청	*확청/NNG
확충	*확충/NNG
환가	*환가/NNG
환각	*환각/NNG
환경	*환경/NNG
환곡	*환곡/NNG
환공	*환공/NNP
환관	*환관/NNG
환국	*환국/NNG
환궁	*환궁/NNG
환규	*환규/NNG
환금	*환금/NNG
환급	*환급/NNG
환기	*환기/NNG
환담	*환담/NNG
환대	*환대/NNG
환도	*환도/NNG
환락	*환락/NNG
환매	*환매/NNG
환물	*환물/NNG
환부	*환부/NNG
환불	*환불/NNG
환산	*환산/NNG
환상	*환상/NNG
환생	*환생/NNG
환성	*환성/NNG
환세	*환세/NNG
환소	*환소/NNG
환속	*환속/NNG
환송	*환송/NNG
환수	*환수/NNG
환승	*환승/NNG
환시	*환시/NNG
환심	*환심/NNG
환어	*환어/NNG
환언	*환언/NNG
환영	*환영/NNG
환원	*환원/NNG
환유	*환유/NNG
환은	*환은/NNP
환의	*환의/NNG
환장	*환장/NNG
환전	*환전/NNG
환절	*환절/NNG
환정	*환정/NNG
환제	*환제/NNG
환주	*환주/NNP
환지	*환지/NNG
환취	*환취/NNG
환치	*환치/NNG
환칠	*환칠/NNG
환향	*환향/NNG
환형	*환형/NNG
환호	*환호/NNG
환화	*환화/NNP
환희	*환희/NNG
활강	*활강/NNG
활대	*활대/NNG
활동	*활동/NNG
활딱	*활딱/NNG
활보	*활보/NNG
활약	*활약/NNG
활용	*활용/NNG
활인	*활인/NNG
활주	*활주/NNG
활착	*활착/NNG
홧홧	*홧홧/MAG
황감	*황감/NNG
황구	*황구/NNG
황기	*황기/NNG
황망	*황망/NNG
황변	*황변/NNG
황음	*황음/NNG
황잡	*황잡/VV
황주	*황주/NNP
황칠	*황칠/NNG
황태	*황태/NNG
황폐	*황폐/NNG
황홀	*황홀/NNG
황화	*황화/NNG
회가	*회가/NNG
회감	*회감/NNG
회강	*회강/NNG
회개	*회개/NNG
회격	*회격/NNG
회견	*회견/NNG
회계	*회계/NNG
회고	*회고/NNG
회곡	*회곡/NNG
회교	*회교/NNG
회군	*회군/NNG
회귀	*회귀/NNG
회담	*회담/NNG
회답	*회답/NNG
회당	*회당/NNG
회동	*회동/NNG
회두	*회두/NNG
회람	*회람/NNG
회뢰	*회뢰/NNG
회맹	*회맹/NNG
회벽	*회벽/NNG
회보	*회보/NNG
회복	*회복/NNG
회부	*회부/NNG
회비	*회비/NNG
회사	*회사/NNG
회산	*회산/NNP
회상	*회상/NNG
회색	*회색/NNG
회생	*회생/NNG
회선	*회선/NNG
회송	*회송/NNG
회수	*회수/NNG
회시	*회시/NNG
회식	*회식/NNG
회신	*회신/NNG
회심	*회심/NNG
회양	*회양/NNP
회억	*회억/NNG
회오	*회오/NNG
회유	*회유/NNG
회음	*회음/NNG
회의	*회의/NNG
회임	*회임/NNG
회자	*회자/NNG
회작	*회작/NNG
회장	*회장/NNG
회정	*회정/NNG
회주	*회주/NNG
회진	*회진/NNG
회창	*회창/NNP
회춘	*회춘/NNG
회칠	*회칠/NNG
회태	*회태/NNG
회토	*회토/NNG
회통	*회통/NNG
회피	*회피/NNG
회한	*회한/NNG
회합	*회합/NNG
회항	*회항/NNG
회향	*회향/NNG
회화	*회화/NNG
회환	*회환/NNG
획득	*획득/NNG
획정	*획정/NNG
획책	*획책/NNG
획하	*획하/NNG
횡단	*횡단/NNG
횡렬	*횡렬/NNG
횡령	*횡령/NNG
횡문	*횡문/NNG
횡보	*횡보/NNG
횡사	*횡사/NNG
횡서	*횡서/NNG
횡와	*횡와/NNG
횡재	*횡재/NNG
횡절	*횡절/NNG
횡포	*횡포/NNG
횡행	*횡행/NNG
횡횡	*횡횡/NNG
효감	*효감/NNG
효경	*효경/NNP
효도	*효도/NNG
효수	*효수/NNG
효순	*효순/NNP
효시	*효시/NNG
효양	*효양/NNG
효오	*효오/NNG
효용	*효용/NNG
효유	*효유/NNG
효주	*효주/NNG
효친	*효친/NNG
효행	*효행/NNG
후각	*후각/NNG
후견	*후견/NNG
후계	*후계/NNG
후기	*후기/NNG
후끈	*후끈/MAG
후대	*후대/NNG
후덕	*후덕/NNG
후둑	*후둑/MAG
후들	*후들/MAG
후략	*후략/NNG
후렴	*후렴/NNG
후룩	*후룩/MAG
후륵	*후륵/MAG
후면	*후면/NNG
후문	*후문/NNG
후미	*후미/NNG
후박	*후박/NNG
후발	*후발/NNG
후불	*후불/NNG
후사	*후사/NNG
후산	*후산/NNG
후속	*후속/NNG
후손	*후손/NNG
후송	*후송/NNG
후술	*후술/NNG
후식	*후식/NNG
후안	*후안/NNP
후염	*후염/NNG
후우	*후우/IC
후원	*후원/NNG
후장	*후장/NNG
후조	*후조/NNG
후주	*후주/NNG
후진	*후진/NNG
후취	*후취/NNG
후치	*후치/NNP
후퇴	*후퇴/NNG
후풍	*후풍/NNG
후행	*후행/NNG
후회	*후회/NNG
후후	*후후/MAG
훅훅	*훅훅/MAG
훈계	*훈계/NNG
훈고	*훈고/NNG
훈도	*훈도/NNG
훈련	*훈련/NNG
훈령	*훈령/NNG
훈방	*훈방/NNG
훈수	*훈수/NNG
훈시	*훈시/NNG
훈연	*훈연/NNG
훈육	*훈육/NNG
훈자	*훈자/NNP
훈제	*훈제/NNG
훈증	*훈증/NNG
훈화	*훈화/NNG
훌떡	*훌떡/MAG
훌렁	*훌렁/MAG
훌쩍	*훌쩍/MAG
훌훌	*훌훌/MAG
훗훗	*훗훗/MAG
훤소	*훤소/NNG
훼멸	*훼멸/NNG
훼방	*훼방/NNG
훼상	*훼상/NNG
훼손	*훼손/NNG
훼욕	*훼욕/NNG
훼절	*훼절/NNG
휘동	*휘동/NNG
휘딱	*휘딱/MAG
휘뚝	*휘뚝/MAG
휘발	*휘발/NNG
휘유	*휘유/MAG
휘청	*휘청/MAG
휘호	*휘호/NNG
휘휘	*휘휘/MAG
휙휙	*휙휙/MAG
휭휭	*휭휭/MAG
휴간	*휴간/NNG
휴강	*휴강/NNG
휴거	*휴거/NNG
휴게	*휴게/NNG
휴경	*휴경/NNG
휴고	*휴고/NNP
휴관	*휴관/NNG
휴교	*휴교/NNG
휴대	*휴대/NNG
휴등	*휴등/NNG
휴면	*휴면/NNG
휴무	*휴무/NNG
휴식	*휴식/NNG
휴양	*휴양/NNG
휴업	*휴업/NNG
휴이	*휴이/NNG
휴장	*휴장/NNG
휴전	*휴전/NNG
휴정	*휴정/NNG
휴지	*휴지/NNG
휴직	*휴직/NNG
휴진	*휴진/NNG
휴학	*휴학/NNG
휴한	*휴한/NNG
휴회	*휴회/NNG
흉급	*흉급/NNG
흉사	*흉사/NNG
흉살	*흉살/NNG
흉악	*흉악/NNG
흉측	*흉측/NNG
흉포	*흉포/NNG
흉한	*흉한/NNG
흐흐	*흐흐/MAG
흑암	*흑암/NNG
흑흑	*흑흑/MAG
흔들	*흔들/VV
흘금	*흘금/MAG
흘긋	*흘긋/MAG
흘깃	*흘깃/MAG
흘끔	*흘끔/MAG
흘끗	*흘끗/MAG
흘낏	*흘낏/MAG
흘레	*흘레/NNG
흙일	*흙일/NNG
흙칠	*흙칠/NNG
흠결	*흠결/NNG
흠모	*흠모/NNG
흠숭	*흠숭/NNG
흠앙	*흠앙/NNG
흠칫	*흠칫/MAG
흠향	*흠향/NNG
흠흠	*흠흠/IC
흡기	*흡기/NNG
흡사	*흡사/MAG
흡수	*흡수/NNG
흡습	*흡습/NNG
흡연	*흡연/NNG
흡열	*흡열/NNG
흡인	*흡인/NNG
흡입	*흡입/NNG
흡족	*흡족/NNG
흡진	*흡진/NNG
흡착	*흡착/NNG
흡혈	*흡혈/NNG
흥감	*흥감/NNG
흥국	*흥국/NNP
흥기	*흥기/NNG
흥륭	*흥륭/NNG
흥복	*흥복/NNG
흥분	*흥분/NNG
흥산	*흥산/NNP
흥성	*흥성/NNG
흥야	*흥야/NNG
흥업	*흥업/NNG
흥정	*흥정/NNG
흥진	*흥진/NNP
흥행	*흥행/NNG
흥흥	*흥흥/MAG
희끗	*희끗/MAG
희도	*희도/NNP
희뜩	*희뜩/MAG
희락	*희락/NNG
희롱	*희롱/NNG
희망	*희망/NNG
희사	*희사/NNG
희생	*희생/NNG
희석	*희석/NNG
희소	*희소/NNG
희열	*희열/NNG
희원	*희원/NNG
희작	*희작/NNG
희학	*희학/NNG
희화	*희화/NNG
히뜩	*히뜩/MAG
히죽	*히죽/MAG
히쭉	*히쭉/MAG
히트	*히트/NNG
히히	*히히/IC
힐긋	*힐긋/MAG
힐끔	*힐끔/MAG
힐끗	*힐끗/MAG
힐난	*힐난/NNG
힐문	*힐문/NNG
힐책	*힐책/NNG
값	*값/NNG
겸	*겸/NNB
경	*경/NNG
곡	*곡/NNG
곤	*곤/NNG
교	*교/NNG
굿	*굿/NNG
궁	*궁/NNG
궐	*궐/NNG
극	*극/NNG
글	*글/NNG
금	*금/NNG
꼭	*꼭/MAG
끽	*끽/MAG
낙	*낙/NNG
낯	*낯/NNG
냉	*냉/NNG
념	*념/NNG
농	*농/NNG
눌	*눌/VV
능	*능/NNG
답	*답/NNG
더	*더/MAG
독	*독/NNG
둘	*둘/NR
득	*득/NNG
듯	*듯/NNB
딱	*딱/MAG
뚱	*뚱/MAG
뜸	*뜸/NNG
뜻	*뜻/NNG
띵	*띵/MAG
례	*례/NNG
롱	*롱/NNG
망	*망/NNG
묘	*묘/NNG
무	*무/NNG
뭐	*뭐/NP
뭣	*뭣/NP
벽	*벽/NNG
복	*복/NNG
붕	*붕/MAG
빔	*빔/NNG
뻔	*뻔/NNB
뽀	*뽀/MAG
생	*생/NNG
소	*소/NNG
송	*송/NNP
쇼	*쇼/NNG
숫	*숫/NNG
숱	*숱/NNG
슛	*슛/NNG
쌈	*쌈/NNG
앵	*앵/MAG
역	*역/NNG
염	*염/NNG
욕	*욕/NNG
용	*용/NNG
욱	*욱/MAG
운	*운/NNG
읍	*읍/NNG
응	*응/IC
족	*족/NNG
즉	*즉/MAG
증	*증/NNG
짠	*짠/MAG
짬	*짬/NNG
쨍	*쨍/MAG
쩡	*쩡/MAG
찡	*찡/MAG
착	*착/MAG
창	*창/NNG
책	*책/NNG
처	*처/NNG
청	*청/NNG
취	*취/NNG
컬	*컬/NNG
코	*코/NNG
킬	*킬/NNG
탐	*탐/NNG
탓	*탓/NNG
턴	*턴/NNG
토	*토/NNG
퇴	*퇴/NNG
툭	*툭/MAG
퉤	*퉤/MAG
튀	*튀/VV
팍	*팍/MAG
팽	*팽/MAG
펑	*펑/MAG
폐	*폐/NNG
표	*표/NNG
푹	*푹/MAG
푼	*푼/NNB
풍	*풍/NNG
학	*학/NNG
헉	*헉/MAG
험	*험/IC
혁	*혁/NNP
홀	*홀/NNG
화	*화/NNG
활	*활/NNG
훈	*훈/NNP
휑	*휑/MAG
흉	*흉/NNG
